//MAP CONVERTED BY dmm2tgm.py THIS HEADER COMMENT PREVENTS RECONVERSION, DO NOT REMOVE
"b" = (
/obj/item/flashlight/lantern{
	on = 1
	},
/turf/open/floor/plating/asteroid/basalt/lava_land_surface,
/area/lavaland/surface/dorf)
"c" = (
/obj/structure/water_source/puddle,
/turf/open/floor/plating/asteroid{
	initial_gas_mix = "LAVALAND_ATMOS"
	},
/area/lavaland/surface/dorf)
"d" = (
/obj/structure/table/wood,
/obj/item/pickaxe{
	pixel_x = 4;
	pixel_y = 4
	},
/obj/item/pickaxe{
	pixel_x = -4;
	pixel_y = 3
	},
/obj/item/areaeditor/dwarf{
	pixel_x = 2;
	pixel_y = -2
	},
/turf/open/floor/plating/asteroid/basalt/lava_land_surface,
/area/lavaland/surface/dorf)
"e" = (
/turf/open/floor/plating/asteroid/basalt/lava_land_surface,
/area/lavaland/surface/dorf)
"f" = (
/turf/open/floor/plating/asteroid{
	initial_gas_mix = "LAVALAND_ATMOS"
	},
/area/lavaland/surface/dorf)
"g" = (
/obj/machinery/smelter,
/turf/open/floor/plating/asteroid/basalt/lava_land_surface,
/area/lavaland/surface/dorf)
"i" = (
/mob/living/simple_animal/cow/lavaland,
/obj/item/flashlight/lantern{
	on = 1
	},
/turf/open/floor/plating/asteroid/basalt/lava_land_surface,
/area/lavaland/surface/dorf)
"j" = (
/obj/structure/fermenting_barrel,
/turf/open/floor/plating/asteroid/basalt/lava_land_surface,
/area/lavaland/surface/dorf)
"o" = (
/obj/structure/chair/wood,
/turf/open/floor/plating/asteroid/basalt/lava_land_surface,
/area/lavaland/surface/dorf)
"p" = (
/obj/structure/table/wood,
/obj/item/storage/bag/plants/portaseeder{
	pixel_y = 7
	},
/obj/item/reagent_containers/glass/bucket/wooden{
	pixel_x = -3
	},
/obj/item/reagent_containers/glass/bucket/wooden{
	pixel_x = 5;
	pixel_y = -1
	},
/turf/open/floor/plating/asteroid{
	initial_gas_mix = "LAVALAND_ATMOS"
	},
/area/lavaland/surface/dorf)
"q" = (
/obj/structure/table/wood,
/obj/item/food/grown/mushroom/plumphelmet,
/obj/item/food/grown/mushroom/plumphelmet,
/obj/item/food/grown/mushroom/plumphelmet,
/obj/item/food/grown/mushroom/plumphelmet,
/obj/item/food/grown/mushroom/plumphelmet,
/obj/item/food/grown/mushroom/plumphelmet{
	pixel_x = 10
	},
/obj/item/food/grown/mushroom/plumphelmet{
	pixel_x = 10
	},
/obj/item/food/grown/mushroom/plumphelmet{
	pixel_x = 10
	},
/obj/item/food/grown/mushroom/plumphelmet{
	pixel_x = 10
	},
/turf/open/floor/plating/asteroid/basalt/lava_land_surface,
/area/lavaland/surface/dorf)
"u" = (
/obj/item/flashlight/lantern{
	on = 1
	},
/turf/open/floor/plating/asteroid{
	initial_gas_mix = "LAVALAND_ATMOS"
	},
/area/lavaland/surface/dorf)
"v" = (
/obj/structure/table/wood,
/obj/item/reagent_containers/food/drinks/wooden_mug,
/obj/item/reagent_containers/food/drinks/wooden_mug,
/obj/item/reagent_containers/food/drinks/wooden_mug,
/obj/item/reagent_containers/food/drinks/wooden_mug,
/obj/item/reagent_containers/food/drinks/wooden_mug{
	pixel_x = 6
	},
/obj/item/reagent_containers/food/drinks/wooden_mug{
	pixel_x = 6
	},
/obj/item/reagent_containers/food/drinks/wooden_mug{
	pixel_x = 6
	},
/turf/open/floor/plating/asteroid/basalt/lava_land_surface,
/area/lavaland/surface/dorf)
"x" = (
/turf/open/floor/plating/asteroid/basalt/lava_land_surface,
/area/lavaland/surface/outdoors/explored)
"A" = (
/turf/template_noop,
/area/template_noop)
"D" = (
/obj/structure/table/wood,
/turf/open/floor/plating/asteroid/basalt/lava_land_surface,
/area/lavaland/surface/dorf)
"E" = (
/mob/living/simple_animal/cow/lavaland,
/turf/open/floor/plating/asteroid/basalt/lava_land_surface,
/area/lavaland/surface/dorf)
"G" = (
/obj/structure/table/wood,
/obj/item/shovel{
	pixel_x = 2;
	pixel_y = -1
	},
/obj/item/shovel{
	pixel_x = -1;
	pixel_y = 5
	},
/obj/item/flashlight/lantern{
	on = 1;
	pixel_x = 6
	},
/turf/open/floor/plating/asteroid/basalt/lava_land_surface,
/area/lavaland/surface/dorf)
"H" = (
/obj/item/grown/log/tree,
/obj/item/grown/log/tree,
/obj/item/grown/log/tree,
/obj/item/grown/log/tree,
/obj/item/grown/log/tree,
/turf/open/floor/plating/asteroid/basalt/lava_land_surface,
/area/lavaland/surface/dorf)
"I" = (
/obj/item/flashlight/lantern,
/obj/item/flashlight/lantern,
/obj/item/flashlight/lantern,
/obj/item/flashlight/lantern,
/obj/structure/table/wood,
/obj/item/flashlight/lantern,
/turf/open/floor/plating/asteroid/basalt/lava_land_surface,
/area/lavaland/surface/dorf)
"J" = (
/obj/machinery/anvil,
/turf/open/floor/plating/asteroid/basalt/lava_land_surface,
/area/lavaland/surface/dorf)
"K" = (
/obj/item/stack/ore/glass{
	amount = 5
	},
/turf/open/floor/plating/asteroid{
	initial_gas_mix = "LAVALAND_ATMOS"
	},
/area/lavaland/surface/dorf)
"L" = (
/obj/effect/mob_spawn/human/dwarf_dorm,
/turf/open/floor/plating/asteroid/basalt/lava_land_surface,
/area/lavaland/surface/dorf)
"O" = (
/obj/structure/table/wood,
/obj/item/seeds/glowshroom{
	pixel_x = -3;
	pixel_y = 5
	},
/obj/item/seeds/glowshroom{
	pixel_x = -3;
	pixel_y = 5
	},
/obj/item/seeds/glowshroom{
	pixel_x = -3;
	pixel_y = 5
	},
/obj/item/seeds/glowshroom{
	pixel_x = -3;
	pixel_y = 5
	},
/obj/item/seeds/glowshroom{
	pixel_x = -3;
	pixel_y = 5
	},
/obj/item/seeds/tower{
	pixel_x = 4;
	pixel_y = -5
	},
/obj/item/seeds/tower{
	pixel_x = 4;
	pixel_y = -5
	},
/obj/item/seeds/tower{
	pixel_x = 4;
	pixel_y = -5
	},
/obj/item/seeds/tower{
	pixel_x = 4;
	pixel_y = -5
	},
/obj/item/seeds/tower{
	pixel_x = 4;
	pixel_y = -5
	},
/turf/open/floor/plating/asteroid{
	initial_gas_mix = "LAVALAND_ATMOS"
	},
/area/lavaland/surface/dorf)
"P" = (
/obj/structure/table/wood,
/obj/item/reagent_containers/molten_container/crucible{
	pixel_x = -5;
	pixel_y = 6
	},
/obj/item/reagent_containers/molten_container/crucible{
	pixel_x = 6;
	pixel_y = 1
	},
/turf/open/floor/plating/asteroid/basalt/lava_land_surface,
/area/lavaland/surface/dorf)
"Q" = (
/obj/structure/mineral_door/wood,
/turf/open/floor/plating/asteroid/basalt/lava_land_surface,
/area/lavaland/surface/dorf)
"U" = (
/obj/structure/table/wood,
/obj/item/paper{
	info = "<p>To make fine Dwarven equipment you will first need to collect ore by mining. The smelter will melt down ore to extract its metal, which requires you to insert logs and a crucible. Interact with the smelter again to remove the filled crucible.</p><p>Now you need a clay mold to pour your metal into. Clay can be made by compacting sand, ash, or sandstone. Other areas are said to have clay deposits found everywhere. How useless all that clay would be.</p><p>Next, pour the crucible contents into the mold. Place the mold on the anvil and hit it with the smithing hammer to form your metal. Finally, craft the metal piece with materials like logs or leather to complete your equipment.</p>";
	name = "Dwarven Smithing";
	pixel_x = 10;
	pixel_y = 9
	},
/obj/item/book/granter/crafting_recipe/dwarf{
	pixel_x = -6;
	pixel_y = 3
	},
/obj/item/melee/smith_hammer{
	pixel_x = 5;
	pixel_y = -2
	},
/obj/item/melee/smith_hammer{
	pixel_x = 6;
	pixel_y = 1
	},
/turf/open/floor/plating/asteroid/basalt/lava_land_surface,
/area/lavaland/surface/dorf)
"W" = (
/obj/structure/table/wood,
/obj/item/hatchet{
	pixel_x = -7
	},
/obj/item/hatchet{
	pixel_x = -7;
	pixel_y = 6
	},
/obj/item/cultivator{
	pixel_x = 7;
	pixel_y = -2
	},
/obj/item/cultivator{
	pixel_x = 7;
	pixel_y = 4
	},
/turf/open/floor/plating/asteroid{
	initial_gas_mix = "LAVALAND_ATMOS"
	},
/area/lavaland/surface/dorf)
"Z" = (
/turf/closed/wall/mineral/wood,
/area/lavaland/surface/dorf)

(1,1,1) = {"
A
A
A
A
A
A
A
A
A
x
x
A
A
A
A
A
A
A
A
A
"}
(2,1,1) = {"
A
A
A
A
A
A
A
A
A
x
x
A
A
A
A
A
A
A
A
A
"}
(3,1,1) = {"
A
A
Z
Z
Z
Z
Z
Z
Z
Q
Q
Z
Z
Z
Z
Z
Z
Z
A
A
"}
(4,1,1) = {"
A
A
Z
L
Z
L
Z
L
Z
e
e
Z
P
g
Z
J
b
Z
A
A
"}
(5,1,1) = {"
A
A
Z
Q
Z
Q
Z
Q
Z
e
e
Z
e
e
e
e
e
Z
A
A
"}
(6,1,1) = {"
A
A
Z
b
e
e
e
e
Z
e
e
Z
H
e
e
e
U
Z
A
A
"}
(7,1,1) = {"
A
A
Z
Q
Z
Q
Z
Q
Z
e
e
Z
Z
e
e
e
Z
Z
A
A
"}
(8,1,1) = {"
A
A
Z
L
Z
L
Z
e
I
e
e
Z
b
e
e
e
d
Z
A
A
"}
(9,1,1) = {"
A
A
Z
Z
Z
Z
Z
e
e
e
e
e
e
e
e
e
e
Z
A
A
"}
(10,1,1) = {"
x
x
Q
e
e
e
e
e
e
e
e
e
e
e
e
e
e
Q
x
x
"}
(11,1,1) = {"
x
x
Q
e
e
e
e
e
e
e
e
e
e
e
e
e
e
Q
x
x
"}
(12,1,1) = {"
A
A
Z
e
e
e
e
e
e
o
q
e
f
f
f
f
O
Z
A
A
"}
(13,1,1) = {"
A
A
Z
Z
Q
Z
Z
b
e
o
v
e
f
f
f
f
p
Z
A
A
"}
(14,1,1) = {"
A
A
Z
e
e
e
Z
j
e
e
D
e
f
f
f
f
K
Z
A
A
"}
(15,1,1) = {"
A
A
Z
E
E
e
Z
j
e
e
e
e
f
f
f
f
c
Z
A
A
"}
(16,1,1) = {"
A
A
Z
e
e
e
Z
e
e
e
e
e
f
f
f
f
u
Z
A
A
"}
(17,1,1) = {"
A
A
Z
i
E
e
Z
e
e
e
e
G
W
f
f
f
f
Z
A
A
"}
(18,1,1) = {"
A
A
Z
Z
Z
Z
Z
Z
Z
Q
Q
Z
Z
Z
Z
Z
Z
Z
A
A
"}
(19,1,1) = {"
A
A
A
A
A
A
A
A
A
x
x
A
A
A
A
A
A
A
A
A
"}
(20,1,1) = {"
A
A
A
A
A
A
A
A
A
x
x
A
A
A
A
A
A
A
A
A
"}
