"a" = (/turf/template_noop,/area/template_noop)
"b" = (/obj/structure/glowshroom/single,/turf/closed/mineral/volcanic/lava_land_surface,/area/lavaland/surface/outdoors/explored)
"c" = (/turf/open/indestructible/necropolis,/area/lavaland/surface/outdoors/explored)
"d" = (/turf/open/floor/plating/asteroid/basalt/lava_land_surface,/area/lavaland/surface/outdoors/explored)
"e" = (/obj/structure/glowshroom/single,/turf/open/floor/plating/asteroid/basalt/lava_land_surface,/area/lavaland/surface/outdoors/explored)
"f" = (/turf/closed/wall/mineral/wood,/area/lavaland/surface/dorf)
"g" = (/obj/structure/mineral_door/wood,/turf/open/floor/plating/asteroid/basalt/lava_land_surface,/area/lavaland/surface/dorf)
"h" = (/obj/structure/mineral_door/wood,/turf/open/indestructible/necropolis,/area/lavaland/surface/dorf)
"i" = (/obj/structure/glowshroom/single,/turf/closed/wall/mineral/wood,/area/lavaland/surface/dorf)
"j" = (/turf/open/floor/plating/asteroid/basalt/lava_land_surface,/area/lavaland/surface/dorf)
"k" = (/obj/effect/mob_spawn/human/dwarf_dorm,/obj/structure/glowshroom/single,/turf/open/floor/plating/asteroid/basalt/lava_land_surface,/area/lavaland/surface/dorf)
"l" = (/obj/structure/glowshroom/single,/turf/open/indestructible/necropolis,/area/lavaland/surface/dorf)
"m" = (/turf/open/indestructible/necropolis,/area/lavaland/surface/dorf)
"n" = (/obj/structure/glowshroom/single,/turf/open/floor/plating/asteroid/basalt/lava_land_surface,/area/lavaland/surface/dorf)
"o" = (/obj/structure/table/wood,/obj/item/flashlight/lantern{step_x = 0; step_y = 0},/obj/item/flashlight/lantern{step_x = 0; step_y = 0},/obj/structure/glowshroom/single,/turf/open/indestructible/necropolis,/area/lavaland/surface/dorf)
"p" = (/turf/open/floor/plating/asteroid,/area/lavaland/surface/dorf)
"q" = (/obj/structure/mineral_door/wood,/obj/structure/glowshroom/single,/turf/open/floor/plating/asteroid/basalt/lava_land_surface,/area/lavaland/surface/dorf)
"r" = (/obj/machinery/smelter,/turf/open/floor/plating/asteroid/basalt/lava_land_surface,/area/lavaland/surface/dorf)
"s" = (/obj/machinery/anvil,/turf/open/floor/plating/asteroid/basalt/lava_land_surface,/area/lavaland/surface/dorf)
"t" = (/obj/structure/table/wood,/obj/item/melee/smith_hammer{step_x = -2; step_y = 2},/obj/item/melee/smith_hammer{step_x = -2; step_y = 2},/turf/open/indestructible/necropolis,/area/lavaland/surface/dorf)
"u" = (/obj/structure/table/wood,/obj/item/pickaxe,/obj/item/pickaxe,/turf/open/indestructible/necropolis,/area/lavaland/surface/dorf)
"v" = (/obj/structure/glowshroom/single,/turf/open/floor/plating/asteroid,/area/lavaland/surface/dorf)
"w" = (/obj/structure/table/wood,/obj/item/shovel,/obj/item/shovel,/turf/open/floor/plating/asteroid/basalt/lava_land_surface,/area/lavaland/surface/dorf)
"x" = (/obj/structure/glowshroom/single,/turf/open/indestructible/necropolis,/area/lavaland/surface/outdoors/explored)
"y" = (/obj/item/hatchet,/obj/item/hatchet,/turf/open/floor/plating/asteroid,/area/lavaland/surface/dorf)
"z" = (/obj/structure/sink/puddle,/turf/open/floor/plating/asteroid,/area/lavaland/surface/dorf)
"A" = (/obj/item/cultivator,/obj/item/cultivator,/turf/open/floor/plating/asteroid,/area/lavaland/surface/dorf)
"B" = (/obj/structure/chair/wood{step_y = 0},/turf/open/floor/plating/asteroid/basalt/lava_land_surface,/area/lavaland/surface/dorf)
"C" = (/obj/structure/table/wood,/obj/item/grown/log/tree,/obj/item/grown/log/tree,/obj/item/grown/log/tree,/obj/item/grown/log/tree,/obj/item/grown/log/tree,/turf/open/floor/plating/asteroid/basalt/lava_land_surface,/area/lavaland/surface/dorf)
"D" = (/obj/effect/mob_spawn/human/dwarf_dorm,/turf/open/floor/plating/asteroid/basalt/lava_land_surface,/area/lavaland/surface/dorf)
"E" = (/obj/item/reagent_containers/glass/bucket,/obj/item/reagent_containers/glass/bucket,/turf/open/floor/plating/asteroid,/area/lavaland/surface/dorf)
"F" = (/obj/structure/table/wood,/obj/item/seeds/glowshroom,/obj/item/seeds/glowshroom,/obj/item/seeds/glowshroom,/obj/item/seeds/glowshroom,/obj/item/seeds/glowshroom,/obj/item/seeds/tower,/obj/item/seeds/tower,/obj/item/seeds/tower,/obj/item/seeds/tower,/obj/item/seeds/tower,/obj/structure/glowshroom/single,/turf/open/floor/plating/asteroid,/area/lavaland/surface/dorf)
"G" = (/obj/structure/table/wood,/obj/item/reagent_containers/food/drinks/wooden_mug{step_x = 0; step_y = 0},/obj/item/reagent_containers/food/drinks/wooden_mug{step_x = 0; step_y = 0},/obj/item/reagent_containers/food/drinks/wooden_mug{step_x = 0; step_y = 0},/obj/item/reagent_containers/food/drinks/wooden_mug{step_x = 0; step_y = 0},/obj/item/reagent_containers/food/drinks/wooden_mug{step_x = 0; step_y = 0},/obj/item/reagent_containers/food/drinks/wooden_mug{step_x = 0; step_y = 0},/obj/item/reagent_containers/food/drinks/wooden_mug{step_x = 0; step_y = 0},/turf/open/floor/plating/asteroid/basalt/lava_land_surface,/area/lavaland/surface/dorf)
"H" = (/obj/structure/fermenting_barrel,/turf/open/indestructible/necropolis,/area/lavaland/surface/dorf)
"I" = (/obj/structure/table/wood,/obj/item/reagent_containers/food/snacks/grown/mushroom/plumphelmet,/obj/item/reagent_containers/food/snacks/grown/mushroom/plumphelmet,/obj/item/reagent_containers/food/snacks/grown/mushroom/plumphelmet{step_x = 9; step_y = 4},/obj/item/reagent_containers/food/snacks/grown/mushroom/plumphelmet{step_x = 9; step_y = 18},/obj/item/reagent_containers/food/snacks/grown/mushroom/plumphelmet{step_x = 7; step_y = 13},/obj/item/reagent_containers/food/snacks/grown/mushroom/plumphelmet{step_x = 11; step_y = 5},/obj/item/reagent_containers/food/snacks/grown/mushroom/plumphelmet{step_x = 15; step_y = 7},/obj/item/reagent_containers/food/snacks/grown/mushroom/plumphelmet{step_x = 5; step_y = 3},/obj/item/reagent_containers/food/snacks/grown/mushroom/plumphelmet{step_x = 3; step_y = 10},/turf/open/floor/plating/asteroid/basalt/lava_land_surface,/area/lavaland/surface/dorf)
"J" = (/obj/structure/table/wood,/obj/item/crucible_tongs,/obj/item/reagent_containers/glass/bucket/iron_crucible_bucket,/turf/open/floor/plating/asteroid/basalt/lava_land_surface,/area/lavaland/surface/dorf)
"K" = (/obj/structure/glowshroom/single,/mob/living/simple_animal/cow/lavaland,/turf/open/floor/plating/asteroid/basalt/lava_land_surface,/area/lavaland/surface/dorf)
"L" = (/turf/closed/mineral/volcanic/lava_land_surface,/area/lavaland/surface/outdoors/explored)
"M" = (/mob/living/simple_animal/cow/lavaland,/turf/open/floor/plating/asteroid/basalt/lava_land_surface,/area/lavaland/surface/dorf)
"Q" = (/turf/closed/mineral/volcanic/lava_land_surface,/area/template_noop)

(1,1,1) = {"
aaaaaaaLaaaLddLaaaaaaaaaa
aaaaLLLLLLLLddLLaaaaaaaaa
aaLLLLLLLLLdddLLLaaaaaaaa
aLLfffffffLdecLLaaaaaaaaa
LLLfkgjgDfLdcbLaaaaaaaaaa
aLLfffnfffLccLLLLaaaaaaaa
aLLfDgngkffhiLLLLLLaaaaaa
LLLfffnfffjjfiffffLLaaaaa
LLLfDqjgljjjgmKjMfLLLLLLa
dddfffffjmnnfjMjMfLLLLLLL
LLdcdgjjmmjjffffiffcLLLLL
aLLfffffojjjjjjpnnqdcxddL
aaLfrstffujmjvjppjgexcddd
aLLfjjmlfwmmnvyzApfLxeLLL
aLLfBBjjjmmlnnvpppfLLLLLL
aLLfCJjjjmmmjpEpppfLLLaLa
aaLffflmjmjffjFffffLaaaaa
aaLLLfhfGjHfjnffLLLLaaaaa
aaaLLcdfImHfmffLLLaaaaaaa
aLLLdddfffffgfLLLaaaaaaaa
LLcccLLLLLLLcLLLQaaaaaaaa
LdccLLLLLLLLdLLLLaaaaaaaa
LddLLLaaaLLLddLLaaaaaaaaa
ddLLLaaaaaaLLdLaaaaaaaaaa
dLLLaaaaaaaaLdLLaaaaaaaaa
"}
