//MAP CONVERTED BY dmm2tgm.py THIS HEADER COMMENT PREVENTS RECONVERSION, DO NOT REMOVE
"a" = (
/turf/template_noop,
/area/template_noop)
"b" = (
/obj/item/flashlight/lantern{
	on = 1
	},
/turf/open/floor/plating/asteroid/basalt/lava_land_surface,
/area/lavaland/surface/dorf)
"c" = (
/obj/structure/mineral_door/wood,
/turf/open/floor/plating/asteroid/basalt/lava_land_surface,
/area/lavaland/surface/dorf)
"d" = (
/turf/open/floor/plating/asteroid/basalt/lava_land_surface,
/area/lavaland/surface/outdoors/explored)
"e" = (
/mob/living/simple_animal/cow/lavaland,
/turf/open/floor/plating/asteroid/basalt/lava_land_surface,
/area/lavaland/surface/dorf)
"f" = (
/turf/closed/wall/mineral/wood,
/area/lavaland/surface/dorf)
"g" = (
/obj/structure/table/wood,
/obj/item/seeds/glowshroom,
/obj/item/seeds/glowshroom,
/obj/item/seeds/glowshroom,
/obj/item/seeds/glowshroom,
/obj/item/seeds/glowshroom,
/obj/item/seeds/tower,
/obj/item/seeds/tower,
/obj/item/seeds/tower,
/obj/item/seeds/tower,
/obj/item/seeds/tower,
/turf/open/floor/plating/asteroid{
	initial_gas_mix = "LAVALAND_ATMOS"
	},
/area/lavaland/surface/dorf)
"h" = (
/obj/structure/table/wood,
/obj/item/flashlight/lantern,
/obj/item/flashlight/lantern,
/obj/item/flashlight/lantern,
/obj/item/flashlight/lantern,
/turf/open/floor/plating/asteroid/basalt/lava_land_surface,
/area/lavaland/surface/dorf)
"i" = (
/obj/item/storage/bag/plants/portaseeder,
/turf/open/floor/plating/asteroid{
	initial_gas_mix = "LAVALAND_ATMOS"
	},
/area/lavaland/surface/dorf)
"j" = (
/turf/open/floor/plating/asteroid/basalt/lava_land_surface,
/area/lavaland/surface/dorf)
"k" = (
/obj/machinery/smelter,
/turf/open/floor/plating/asteroid/basalt/lava_land_surface,
/area/lavaland/surface/dorf)
"l" = (
/obj/machinery/anvil,
/turf/open/floor/plating/asteroid/basalt/lava_land_surface,
/area/lavaland/surface/dorf)
"n" = (
/obj/effect/mob_spawn/human/dwarf_dorm,
/turf/open/floor/plating/asteroid/basalt/lava_land_surface,
/area/lavaland/surface/dorf)
"o" = (
/obj/structure/table/wood,
/obj/item/pickaxe,
/obj/item/pickaxe,
/turf/open/floor/plating/asteroid/basalt/lava_land_surface,
/area/lavaland/surface/dorf)
"q" = (
/obj/structure/table/wood,
/obj/item/shovel,
/obj/item/shovel,
/obj/item/paper{
	info = "In order to make a mold for the forging process clay is required. The easiest way to obtain clay is by dunking some sand or ash in water. Other areas are said to have clay deposits found everywhere. How useless all that clay would be.";
	name = "Making Molds"
	},
/turf/open/floor/plating/asteroid/basalt/lava_land_surface,
/area/lavaland/surface/dorf)
"r" = (
/obj/item/hatchet,
/obj/item/hatchet,
/turf/open/floor/plating/asteroid{
	initial_gas_mix = "LAVALAND_ATMOS"
	},
/area/lavaland/surface/dorf)
"s" = (
/obj/structure/sink/puddle,
/turf/open/floor/plating/asteroid{
	initial_gas_mix = "LAVALAND_ATMOS"
	},
/area/lavaland/surface/dorf)
"t" = (
/obj/structure/chair/wood,
/turf/open/floor/plating/asteroid/basalt/lava_land_surface,
/area/lavaland/surface/dorf)
"u" = (
/obj/item/stack/ore/glass{
	amount = 5
	},
/turf/open/floor/plating/asteroid{
	initial_gas_mix = "LAVALAND_ATMOS"
	},
/area/lavaland/surface/dorf)
"v" = (
/obj/structure/table/wood,
/obj/item/grown/log/tree,
/obj/item/grown/log/tree,
/obj/item/grown/log/tree,
/obj/item/grown/log/tree,
/obj/item/grown/log/tree,
/turf/open/floor/plating/asteroid/basalt/lava_land_surface,
/area/lavaland/surface/dorf)
"w" = (
/obj/structure/table/wood,
/obj/item/crucible_tongs,
/obj/item/reagent_containers/glass/bucket/iron_crucible_bucket,
/turf/open/floor/plating/asteroid/basalt/lava_land_surface,
/area/lavaland/surface/dorf)
"x" = (
/obj/item/reagent_containers/glass/bucket/wooden,
/obj/item/reagent_containers/glass/bucket/wooden,
/turf/open/floor/plating/asteroid{
	initial_gas_mix = "LAVALAND_ATMOS"
	},
/area/lavaland/surface/dorf)
"y" = (
/obj/item/flashlight/lantern{
	on = 1
	},
/turf/open/floor/plating/asteroid{
	initial_gas_mix = "LAVALAND_ATMOS"
	},
/area/lavaland/surface/dorf)
"z" = (
/obj/structure/table/wood,
/obj/item/reagent_containers/food/drinks/wooden_mug,
/obj/item/reagent_containers/food/drinks/wooden_mug,
/obj/item/reagent_containers/food/drinks/wooden_mug,
/obj/item/reagent_containers/food/drinks/wooden_mug,
/obj/item/reagent_containers/food/drinks/wooden_mug,
/obj/item/reagent_containers/food/drinks/wooden_mug,
/obj/item/reagent_containers/food/drinks/wooden_mug,
/turf/open/floor/plating/asteroid/basalt/lava_land_surface,
/area/lavaland/surface/dorf)
"A" = (
/obj/structure/fermenting_barrel,
/turf/open/floor/plating/asteroid/basalt/lava_land_surface,
/area/lavaland/surface/dorf)
"B" = (
/obj/structure/table/wood,
/obj/item/reagent_containers/food/snacks/grown/mushroom/plumphelmet,
/obj/item/reagent_containers/food/snacks/grown/mushroom/plumphelmet,
/obj/item/reagent_containers/food/snacks/grown/mushroom/plumphelmet,
/obj/item/reagent_containers/food/snacks/grown/mushroom/plumphelmet,
/obj/item/reagent_containers/food/snacks/grown/mushroom/plumphelmet,
/obj/item/reagent_containers/food/snacks/grown/mushroom/plumphelmet,
/obj/item/reagent_containers/food/snacks/grown/mushroom/plumphelmet,
/obj/item/reagent_containers/food/snacks/grown/mushroom/plumphelmet,
/obj/item/reagent_containers/food/snacks/grown/mushroom/plumphelmet,
/turf/open/floor/plating/asteroid/basalt/lava_land_surface,
/area/lavaland/surface/dorf)
"C" = (
/obj/structure/table/wood,
/obj/item/melee/smith_hammer,
/obj/item/melee/smith_hammer,
/turf/open/floor/plating/asteroid/basalt/lava_land_surface,
/area/lavaland/surface/dorf)
"E" = (
/turf/open/floor/plating/asteroid{
	initial_gas_mix = "LAVALAND_ATMOS"
	},
/area/lavaland/surface/dorf)
"F" = (
/obj/item/cultivator,
/obj/item/cultivator,
/turf/open/floor/plating/asteroid{
	initial_gas_mix = "LAVALAND_ATMOS"
	},
/area/lavaland/surface/dorf)

(1,1,1) = {"
a
a
a
a
a
a
a
d
d
a
a
a
a
a
a
a
a
a
d
d
"}
(2,1,1) = {"
a
f
f
f
f
f
f
f
d
f
f
f
f
f
f
a
a
a
d
d
"}
(3,1,1) = {"
a
f
n
f
n
f
n
f
d
f
k
j
t
v
f
a
a
d
d
a
"}
(4,1,1) = {"
a
f
c
f
c
f
c
f
c
f
l
j
t
w
f
f
d
d
a
a
"}
(5,1,1) = {"
a
f
j
j
b
j
j
f
j
f
C
j
j
j
j
c
d
d
a
a
"}
(6,1,1) = {"
a
f
c
f
c
f
c
f
j
f
f
j
j
j
j
f
f
f
a
a
"}
(7,1,1) = {"
a
f
n
f
n
f
j
j
j
h
f
f
j
b
j
z
B
f
a
a
"}
(8,1,1) = {"
a
f
f
f
f
f
j
j
j
j
o
q
j
j
j
j
j
f
a
a
"}
(9,1,1) = {"
a
a
a
a
f
j
j
j
j
j
j
j
j
j
j
A
A
f
a
a
"}
(10,1,1) = {"
d
d
d
d
c
j
j
j
j
b
j
j
j
j
f
f
f
f
a
a
"}
(11,1,1) = {"
d
d
d
d
f
f
c
f
f
j
j
j
j
j
f
j
j
c
d
d
"}
(12,1,1) = {"
d
d
a
a
a
f
j
b
f
j
E
E
j
E
j
b
f
f
a
a
"}
(13,1,1) = {"
a
a
a
a
a
f
e
e
f
j
j
r
E
x
g
f
f
a
a
a
"}
(14,1,1) = {"
a
a
a
a
a
f
j
j
f
i
E
s
u
E
f
f
a
a
a
a
"}
(15,1,1) = {"
a
a
a
a
a
f
e
e
f
j
E
F
E
E
f
a
a
a
a
a
"}
(16,1,1) = {"
a
a
a
a
a
f
f
f
f
j
j
E
E
y
f
a
a
a
a
a
"}
(17,1,1) = {"
a
a
a
a
a
a
a
a
f
c
c
f
f
f
f
a
a
a
a
a
"}
(18,1,1) = {"
a
a
a
a
a
a
a
a
a
d
d
a
a
a
a
a
a
a
a
a
"}
(19,1,1) = {"
a
a
a
a
a
a
a
a
a
d
d
a
a
a
a
a
a
a
a
a
"}
