//MAP CONVERTED BY dmm2tgm.py THIS HEADER COMMENT PREVENTS RECONVERSION, DO NOT REMOVE
"a" = (
/obj/structure/table/wood,
/obj/item/grown/log/tree,
/obj/item/grown/log/tree,
/obj/item/grown/log/tree,
/obj/item/grown/log/tree,
/obj/item/grown/log/tree,
/obj/item/flashlight/lantern{
	on = 1
	},
/turf/open/floor/plating/asteroid/basalt/lava_land_surface,
/area/lavaland/surface/dorf)
"b" = (
/obj/structure/table/wood,
/obj/item/shovel,
/obj/item/shovel,
/obj/item/paper{
	info = "In order to make a mold for the forging process clay is required. The easiest way to obtain clay is by dunking some sand or ash in water. Other areas are said to have clay deposits found everywhere. How useless all that clay would be.";
	name = "Making Molds"
	},
/turf/open/floor/plating/asteroid/basalt/lava_land_surface,
/area/lavaland/surface/dorf)
"c" = (
/obj/structure/sink/puddle,
/turf/open/floor/plating/asteroid{
	initial_gas_mix = "LAVALAND_ATMOS"
	},
/area/lavaland/surface/dorf)
"d" = (
/obj/structure/fermenting_barrel,
/turf/open/floor/plating/asteroid/basalt/lava_land_surface,
/area/lavaland/surface/dorf)
"e" = (
/turf/open/floor/plating/asteroid/basalt/lava_land_surface,
/area/lavaland/surface/dorf)
"f" = (
/turf/open/floor/plating/asteroid{
	initial_gas_mix = "LAVALAND_ATMOS"
	},
/area/lavaland/surface/dorf)
"i" = (
/obj/item/cultivator,
/obj/item/cultivator,
/turf/open/floor/plating/asteroid{
	initial_gas_mix = "LAVALAND_ATMOS"
	},
/area/lavaland/surface/dorf)
"j" = (
/obj/item/flashlight/lantern{
	on = 1
	},
/turf/open/floor/plating/asteroid/basalt/lava_land_surface,
/area/lavaland/surface/dorf)
"o" = (
/obj/structure/table/wood,
/obj/item/crucible_tongs,
/obj/item/reagent_containers/glass/bucket/iron_crucible_bucket,
/turf/open/floor/plating/asteroid/basalt/lava_land_surface,
/area/lavaland/surface/dorf)
"p" = (
/obj/item/reagent_containers/glass/bucket/wooden,
/obj/item/reagent_containers/glass/bucket/wooden,
/obj/structure/table/wood,
/obj/item/storage/bag/plants/portaseeder,
/obj/item/flashlight/lantern{
	on = 1
	},
/turf/open/floor/plating/asteroid{
	initial_gas_mix = "LAVALAND_ATMOS"
	},
/area/lavaland/surface/dorf)
"q" = (
/obj/item/hatchet,
/obj/item/hatchet,
/turf/open/floor/plating/asteroid{
	initial_gas_mix = "LAVALAND_ATMOS"
	},
/area/lavaland/surface/dorf)
"v" = (
/obj/machinery/anvil,
/turf/open/floor/plating/asteroid/basalt/lava_land_surface,
/area/lavaland/surface/dorf)
"x" = (
/turf/open/floor/plating/asteroid/basalt/lava_land_surface,
/area/lavaland/surface/outdoors/explored)
"A" = (
/turf/template_noop,
/area/template_noop)
"D" = (
/obj/structure/table/wood,
/obj/item/reagent_containers/food/snacks/grown/mushroom/plumphelmet,
/obj/item/reagent_containers/food/snacks/grown/mushroom/plumphelmet,
/obj/item/reagent_containers/food/snacks/grown/mushroom/plumphelmet,
/obj/item/reagent_containers/food/snacks/grown/mushroom/plumphelmet,
/obj/item/reagent_containers/food/snacks/grown/mushroom/plumphelmet,
/obj/item/reagent_containers/food/snacks/grown/mushroom/plumphelmet,
/obj/item/reagent_containers/food/snacks/grown/mushroom/plumphelmet,
/obj/item/reagent_containers/food/snacks/grown/mushroom/plumphelmet,
/obj/item/reagent_containers/food/snacks/grown/mushroom/plumphelmet,
/turf/open/floor/plating/asteroid/basalt/lava_land_surface,
/area/lavaland/surface/dorf)
"E" = (
/mob/living/simple_animal/cow/lavaland,
/turf/open/floor/plating/asteroid/basalt/lava_land_surface,
/area/lavaland/surface/dorf)
"H" = (
/obj/structure/table/wood,
/obj/item/melee/smith_hammer,
/obj/item/melee/smith_hammer,
/turf/open/floor/plating/asteroid/basalt/lava_land_surface,
/area/lavaland/surface/dorf)
"I" = (
/obj/item/flashlight/lantern,
/obj/item/flashlight/lantern,
/obj/item/flashlight/lantern,
/obj/item/flashlight/lantern,
/obj/structure/table/wood,
/obj/item/flashlight/lantern,
/turf/open/floor/plating/asteroid/basalt/lava_land_surface,
/area/lavaland/surface/dorf)
"J" = (
/obj/structure/chair/wood,
/turf/open/floor/plating/asteroid/basalt/lava_land_surface,
/area/lavaland/surface/dorf)
"K" = (
/obj/item/stack/ore/glass{
	amount = 5
	},
/turf/open/floor/plating/asteroid{
	initial_gas_mix = "LAVALAND_ATMOS"
	},
/area/lavaland/surface/dorf)
"L" = (
/obj/effect/mob_spawn/human/dwarf_dorm,
/turf/open/floor/plating/asteroid/basalt/lava_land_surface,
/area/lavaland/surface/dorf)
"O" = (
/obj/structure/table/wood,
/obj/item/seeds/glowshroom,
/obj/item/seeds/glowshroom,
/obj/item/seeds/glowshroom,
/obj/item/seeds/glowshroom,
/obj/item/seeds/glowshroom,
/obj/item/seeds/tower,
/obj/item/seeds/tower,
/obj/item/seeds/tower,
/obj/item/seeds/tower,
/obj/item/seeds/tower,
/turf/open/floor/plating/asteroid{
	initial_gas_mix = "LAVALAND_ATMOS"
	},
/area/lavaland/surface/dorf)
"P" = (
/obj/machinery/smelter,
/turf/open/floor/plating/asteroid/basalt/lava_land_surface,
/area/lavaland/surface/dorf)
"Q" = (
/obj/structure/mineral_door/wood,
/turf/open/floor/plating/asteroid/basalt/lava_land_surface,
/area/lavaland/surface/dorf)
"U" = (
/obj/structure/table/wood,
/obj/item/reagent_containers/food/drinks/wooden_mug,
/obj/item/reagent_containers/food/drinks/wooden_mug,
/obj/item/reagent_containers/food/drinks/wooden_mug,
/obj/item/reagent_containers/food/drinks/wooden_mug,
/obj/item/reagent_containers/food/drinks/wooden_mug,
/obj/item/reagent_containers/food/drinks/wooden_mug,
/obj/item/reagent_containers/food/drinks/wooden_mug,
/turf/open/floor/plating/asteroid/basalt/lava_land_surface,
/area/lavaland/surface/dorf)
"W" = (
/obj/structure/table/wood,
/obj/item/pickaxe,
/obj/item/pickaxe,
/turf/open/floor/plating/asteroid/basalt/lava_land_surface,
/area/lavaland/surface/dorf)
"Z" = (
/turf/closed/wall/mineral/wood,
/area/lavaland/surface/dorf)

(1,1,1) = {"
A
A
A
A
A
A
A
A
A
x
x
A
A
A
A
A
A
A
A
A
"}
(2,1,1) = {"
A
A
A
A
A
A
A
A
A
x
x
A
A
A
A
A
A
A
A
A
"}
(3,1,1) = {"
A
A
Z
Z
Z
Z
Z
Z
Z
Q
Q
Z
Z
Z
Z
Z
Z
Z
A
A
"}
(4,1,1) = {"
A
A
Z
L
Z
L
Z
L
Z
e
e
Z
P
e
e
J
a
Z
A
A
"}
(5,1,1) = {"
A
A
Z
Q
Z
Q
Z
Q
Z
e
e
Z
v
e
e
J
o
Z
A
A
"}
(6,1,1) = {"
A
A
Z
e
e
j
e
e
Z
e
e
Z
H
e
e
e
U
Z
A
A
"}
(7,1,1) = {"
A
A
Z
Q
Z
Q
Z
Q
Z
e
e
Z
W
e
e
e
D
Z
A
A
"}
(8,1,1) = {"
A
A
Z
L
Z
L
Z
e
I
e
e
Z
b
e
e
e
d
Z
A
A
"}
(9,1,1) = {"
A
A
Z
Z
Z
Z
Z
e
e
e
e
j
e
e
e
e
d
Z
A
A
"}
(10,1,1) = {"
x
x
Q
e
e
e
e
e
e
e
e
e
e
e
e
e
e
Q
x
x
"}
(11,1,1) = {"
x
x
Q
e
e
e
e
e
e
e
e
e
e
e
e
e
e
Q
x
x
"}
(12,1,1) = {"
A
A
Z
e
e
e
j
e
e
e
e
e
f
f
f
f
O
Z
A
A
"}
(13,1,1) = {"
A
A
Z
Q
Z
Z
Z
e
e
e
e
e
f
f
f
f
p
Z
A
A
"}
(14,1,1) = {"
A
A
Z
e
j
e
Z
e
e
e
e
e
f
f
q
f
K
Z
A
A
"}
(15,1,1) = {"
A
A
Z
E
E
e
Z
e
e
e
e
e
f
f
f
f
c
Z
A
A
"}
(16,1,1) = {"
A
A
Z
e
e
e
Z
e
e
e
e
e
f
f
i
f
f
Z
A
A
"}
(17,1,1) = {"
A
A
Z
E
E
e
Z
e
j
e
e
e
f
f
f
f
f
Z
A
A
"}
(18,1,1) = {"
A
A
Z
Z
Z
Z
Z
Z
Z
Q
Q
Z
Z
Z
Z
Z
Z
Z
A
A
"}
(19,1,1) = {"
A
A
A
A
A
A
A
A
A
x
x
A
A
A
A
A
A
A
A
A
"}
(20,1,1) = {"
A
A
A
A
A
A
A
A
A
x
x
A
A
A
A
A
A
A
A
A
"}
