//MAP CONVERTED BY dmm2tgm.py THIS HEADER COMMENT PREVENTS RECONVERSION, DO NOT REMOVE
"a" = (
/turf/template_noop,
/area/template_noop)
"b" = (
/turf/closed/mineral/random/volcanic,
/area/lavaland/surface/outdoors/unexplored)
"c" = (
/turf/open/misc/asteroid/basalt/lava_land_surface,
/area/lavaland/surface/outdoors/unexplored)
"d" = (
/turf/open/floor/cult{
	initial_gas_mix = "LAVALAND_ATMOS"
	},
/area/lavaland/surface/outdoors/unexplored)
"e" = (
/obj/item/bodypart/head/golem/cult,
/obj/item/bodypart/arm/left/golem/cult{
	pixel_x = 7;
	pixel_y = -3
	},
/obj/effect/decal/cleanable/blood/old,
/turf/open/misc/asteroid/basalt/lava_land_surface,
/area/lavaland/surface/outdoors/unexplored)
"f" = (
/obj/item/bodypart/chest/golem/cult{
	pixel_x = -7;
	pixel_y = 6
	},
/obj/item/bodypart/leg/left/golem/cult,
/obj/effect/decal/cleanable/blood/old,
/turf/open/misc/asteroid/basalt/lava_land_surface,
/area/lavaland/surface/outdoors/unexplored)
"g" = (
/turf/closed/wall/mineral/cult,
/area/lavaland/surface/outdoors/unexplored)
"h" = (
/obj/item/flashlight/lantern{
	on = 1
	},
/turf/open/misc/asteroid/basalt/lava_land_surface,
/area/lavaland/surface/outdoors/unexplored)
"i" = (
/obj/item/melee/cultblade/dagger,
/obj/effect/decal/cleanable/blood/old,
/turf/open/misc/asteroid/basalt/lava_land_surface,
/area/lavaland/surface/outdoors/unexplored)
"j" = (
/obj/effect/decal/cleanable/blood/old,
/turf/open/misc/asteroid/basalt/lava_land_surface,
/area/lavaland/surface/outdoors/unexplored)
"k" = (
/obj/structure/girder/cult,
/turf/open/misc/asteroid/basalt/lava_land_surface,
/area/lavaland/surface/outdoors/unexplored)
"m" = (
/obj/effect/decal/cleanable/blood/old,
/turf/open/floor/cult{
	initial_gas_mix = "LAVALAND_ATMOS"
	},
/area/lavaland/surface/outdoors/unexplored)
"n" = (
/turf/closed/wall/mineral/cult,
/area/lavaland/surface/dorf_chaos)
"o" = (
/obj/structure/mineral_door/stone,
/turf/open/floor/cult{
	initial_gas_mix = "LAVALAND_ATMOS"
	},
/area/lavaland/surface/dorf_chaos)
"p" = (
/obj/effect/forcefield/cult,
/turf/closed/wall/mineral/cult,
/area/lavaland/surface/dorf_chaos)
"q" = (
/turf/open/floor/cult{
	initial_gas_mix = "LAVALAND_ATMOS"
	},
/area/lavaland/surface/dorf_chaos)
"r" = (
/obj/effect/decal/cleanable/blood/old,
/turf/open/floor/cult{
	initial_gas_mix = "LAVALAND_ATMOS"
	},
/area/lavaland/surface/dorf_chaos)
"s" = (
/obj/effect/temp_visual/cult/sparks,
/turf/closed/wall/mineral/cult,
/area/lavaland/surface/dorf_chaos)
"t" = (
/obj/item/flashlight/lantern{
	on = 1
	},
/turf/open/floor/cult{
	initial_gas_mix = "LAVALAND_ATMOS"
	},
/area/lavaland/surface/dorf_chaos)
"u" = (
/obj/effect/mob_spawn/ghost_role/human/dwarf_dorm/chaos,
/obj/structure/bed,
/obj/item/bedsheet/cult,
/turf/open/floor/cult{
	initial_gas_mix = "LAVALAND_ATMOS"
	},
/area/lavaland/surface/dorf_chaos)
"v" = (
/obj/structure/girder/cult,
/turf/open/floor/cult{
	initial_gas_mix = "LAVALAND_ATMOS"
	},
/area/lavaland/surface/dorf_chaos)
"w" = (
/obj/structure/table/stone,
/obj/item/food/grown/mushroom/plumphelmet{
	pixel_x = 7;
	pixel_y = 8
	},
/obj/item/food/grown/mushroom/plumphelmet{
	pixel_x = -3;
	pixel_y = 6
	},
/obj/item/reagent_containers/cup/glass/wooden_mug{
	pixel_x = 1;
	pixel_y = 2
	},
/turf/open/floor/cult{
	initial_gas_mix = "LAVALAND_ATMOS"
	},
/area/lavaland/surface/dorf_chaos)
"x" = (
/obj/structure/chair/stone{
	dir = 8
	},
/turf/open/floor/cult{
	initial_gas_mix = "LAVALAND_ATMOS"
	},
/area/lavaland/surface/dorf_chaos)
"y" = (
/obj/structure/chair/stone{
	dir = 4
	},
/turf/open/floor/cult{
	initial_gas_mix = "LAVALAND_ATMOS"
	},
/area/lavaland/surface/dorf_chaos)
"z" = (
/obj/structure/table/stone,
/obj/item/food/grown/mushroom/plumphelmet{
	pixel_x = 7;
	pixel_y = 8
	},
/obj/item/food/grown/mushroom/plumphelmet{
	pixel_x = -3;
	pixel_y = 6
	},
/obj/item/reagent_containers/cup/glass/wooden_mug{
	pixel_x = 6
	},
/turf/open/floor/cult{
	initial_gas_mix = "LAVALAND_ATMOS"
	},
/area/lavaland/surface/dorf_chaos)
"A" = (
/obj/structure/table/stone,
/obj/item/food/grown/mushroom/plumphelmet{
	pixel_x = 10
	},
/obj/item/food/grown/mushroom/plumphelmet{
	pixel_x = -3;
	pixel_y = 6
	},
/obj/item/food/grown/mushroom/plumphelmet{
	pixel_x = 7;
	pixel_y = 8
	},
/obj/item/food/grown/mushroom/plumphelmet{
	pixel_x = 7;
	pixel_y = 8
	},
/obj/item/reagent_containers/cup/glass/wooden_mug{
	pixel_x = 1;
	pixel_y = 2
	},
/turf/open/floor/cult{
	initial_gas_mix = "LAVALAND_ATMOS"
	},
/area/lavaland/surface/dorf_chaos)
"B" = (
/obj/structure/fermenting_barrel,
/turf/open/floor/cult{
	initial_gas_mix = "LAVALAND_ATMOS"
	},
/area/lavaland/surface/dorf_chaos)
"C" = (
/obj/structure/chair/stone{
	dir = 1
	},
/turf/open/floor/cult{
	initial_gas_mix = "LAVALAND_ATMOS"
	},
/area/lavaland/surface/dorf_chaos)
"D" = (
/obj/structure/closet/crate/stone,
/obj/item/flashlight/lantern{
	pixel_x = -6;
	pixel_y = 3
	},
/obj/item/flashlight/lantern{
	pixel_x = 7;
	pixel_y = 5
	},
/obj/item/flashlight/lantern{
	pixel_y = 9
	},
/obj/item/flashlight/flare/culttorch,
/turf/open/floor/cult{
	initial_gas_mix = "LAVALAND_ATMOS"
	},
/area/lavaland/surface/dorf_chaos)
"E" = (
/obj/item/stack/ore/glass{
	amount = 30
	},
/turf/open/misc/asteroid/basalt/lava_land_surface,
/area/lavaland/surface/dorf_chaos)
"F" = (
/obj/item/grown/log/tree,
/obj/item/grown/log/tree,
/turf/open/misc/asteroid/basalt/lava_land_surface,
/area/lavaland/surface/dorf_chaos)
"G" = (
/obj/item/grown/log/tree,
/obj/item/grown/log/tree,
/obj/structure/flora/bush/snow/style_random,
/turf/open/misc/asteroid/basalt/lava_land_surface,
/area/lavaland/surface/dorf_chaos)
"H" = (
/obj/item/flashlight/lantern{
	on = 1
	},
/turf/open/misc/asteroid/basalt/lava_land_surface,
/area/lavaland/surface/dorf_chaos)
"I" = (
/obj/structure/closet/crate/stone,
/obj/item/pestle{
	pixel_x = 3;
	pixel_y = 4
	},
/obj/item/kitchen/rollingpin,
/obj/item/reagent_containers/cup/mortar,
/obj/item/knife,
/turf/open/floor/cult{
	initial_gas_mix = "LAVALAND_ATMOS"
	},
/area/lavaland/surface/dorf_chaos)
"J" = (
/obj/structure/closet/crate/stone,
/obj/item/reagent_containers/cup/bucket/wooden{
	pixel_x = -3
	},
/obj/item/reagent_containers/cup/bucket/wooden{
	pixel_x = 8;
	pixel_y = -1
	},
/obj/item/reagent_containers/cup/bucket/wooden{
	pixel_y = 8
	},
/turf/open/floor/cult{
	initial_gas_mix = "LAVALAND_ATMOS"
	},
/area/lavaland/surface/dorf_chaos)
"K" = (
/obj/machinery/smelter,
/turf/open/floor/cult{
	initial_gas_mix = "LAVALAND_ATMOS"
	},
/area/lavaland/surface/dorf_chaos)
"L" = (
/obj/structure/water_source/puddle,
/turf/open/misc/asteroid/basalt/lava_land_surface,
/area/lavaland/surface/dorf_chaos)
"M" = (
/obj/structure/table/stone,
/obj/item/reagent_containers/molten_container/crucible{
	pixel_x = 6;
	pixel_y = 1
	},
/obj/item/stack/sheet/mineral/clay{
	amount = 10
	},
/turf/open/floor/cult{
	initial_gas_mix = "LAVALAND_ATMOS"
	},
/area/lavaland/surface/dorf_chaos)
"N" = (
/obj/item/seeds/glowshroom,
/obj/item/seeds/glowshroom,
/obj/item/seeds/glowshroom,
/obj/item/seeds/glowshroom,
/obj/item/seeds/glowshroom,
/obj/item/seeds/tower,
/obj/item/seeds/tower,
/obj/item/seeds/tower,
/obj/item/seeds/tower,
/obj/item/seeds/tower,
/obj/item/seeds/wheat,
/obj/item/seeds/wheat,
/obj/item/seeds/wheat,
/obj/item/seeds/wheat,
/obj/item/seeds/wheat,
/obj/item/seeds/cotton,
/obj/item/seeds/cotton,
/obj/item/seeds/cotton,
/obj/item/seeds/cotton,
/obj/item/seeds/cotton,
/obj/structure/closet/crate/stone,
/turf/open/misc/asteroid/basalt/lava_land_surface,
/area/lavaland/surface/dorf_chaos)
"O" = (
/obj/machinery/anvil,
/obj/item/book/granter/crafting_recipe/dwarf{
	pixel_x = -6;
	pixel_y = 3
	},
/turf/open/floor/cult{
	initial_gas_mix = "LAVALAND_ATMOS"
	},
/area/lavaland/surface/dorf_chaos)
"P" = (
/obj/structure/table/stone,
/obj/item/cultivator/rake{
	pixel_x = 7;
	pixel_y = -2
	},
/obj/item/hatchet/wooden{
	pixel_x = -4;
	pixel_y = 7
	},
/turf/open/floor/cult{
	initial_gas_mix = "LAVALAND_ATMOS"
	},
/area/lavaland/surface/dorf_chaos)
"Q" = (
/obj/structure/closet/crate/stone,
/obj/item/dwarf_tool,
/obj/item/melee/smith_hammer,
/obj/item/melee/smith_hammer,
/turf/open/floor/cult{
	initial_gas_mix = "LAVALAND_ATMOS"
	},
/area/lavaland/surface/dorf_chaos)
"R" = (
/obj/structure/closet/crate/stone,
/obj/item/reagent_containers/molten_container/smelt_mold/armour,
/obj/item/reagent_containers/molten_container/smelt_mold/bar,
/obj/item/reagent_containers/molten_container/smelt_mold/helmet,
/obj/item/reagent_containers/molten_container/smelt_mold/knife,
/obj/item/reagent_containers/molten_container/smelt_mold/pickaxe,
/obj/item/reagent_containers/molten_container/smelt_mold/shovel,
/obj/item/reagent_containers/molten_container/smelt_mold/sword,
/obj/item/reagent_containers/molten_container/smelt_mold/war_hammer,
/turf/open/floor/cult{
	initial_gas_mix = "LAVALAND_ATMOS"
	},
/area/lavaland/surface/dorf_chaos)
"S" = (
/obj/structure/table/stone,
/obj/item/shovel{
	pixel_x = 8;
	pixel_y = -5
	},
/obj/item/shovel{
	pixel_y = 1
	},
/obj/item/flashlight/lantern{
	on = 1
	},
/turf/open/floor/cult{
	initial_gas_mix = "LAVALAND_ATMOS"
	},
/area/lavaland/surface/dorf_chaos)
"T" = (
/obj/structure/table/stone,
/obj/item/pickaxe{
	pixel_x = 2;
	pixel_y = -1
	},
/obj/item/pickaxe{
	pixel_x = 4;
	pixel_y = 4
	},
/turf/open/floor/cult{
	initial_gas_mix = "LAVALAND_ATMOS"
	},
/area/lavaland/surface/dorf_chaos)

(1,1,1) = {"
a
a
a
a
a
a
a
a
a
a
a
a
a
a
a
a
a
a
a
a
a
a
a
a
a
a
a
a
a
a
a
a
a
a
a
a
"}
(2,1,1) = {"
a
a
a
a
a
a
a
a
a
a
a
a
a
a
a
b
b
b
b
b
b
b
a
a
a
a
a
a
a
a
a
a
a
a
a
a
"}
(3,1,1) = {"
a
a
a
a
a
a
a
a
a
a
a
a
a
b
b
b
b
b
b
b
b
b
b
b
a
a
a
a
a
a
a
a
a
a
a
a
"}
(4,1,1) = {"
a
a
a
a
a
a
a
a
a
a
b
b
b
b
b
b
b
b
b
b
b
k
g
b
b
a
a
a
a
a
a
a
a
a
a
a
"}
(5,1,1) = {"
a
a
a
a
a
a
a
a
a
b
b
b
b
b
b
c
c
c
b
b
b
c
b
b
b
b
b
a
a
a
a
a
a
a
a
a
"}
(6,1,1) = {"
a
a
a
a
a
a
a
a
b
b
b
b
b
b
c
k
k
b
b
b
b
b
b
k
g
b
b
b
a
a
a
a
a
a
a
a
"}
(7,1,1) = {"
a
a
a
a
a
a
a
b
b
b
b
b
b
b
b
b
b
b
b
b
b
b
b
c
g
b
b
b
a
a
a
a
a
a
a
a
"}
(8,1,1) = {"
a
a
a
a
a
a
a
b
b
b
b
b
b
b
b
b
b
b
b
b
b
b
b
b
k
k
b
b
b
a
a
a
a
a
a
a
"}
(9,1,1) = {"
a
a
a
a
a
a
b
b
b
b
b
b
b
n
v
v
v
p
p
n
n
b
b
b
b
b
b
b
b
a
a
a
a
a
a
a
"}
(10,1,1) = {"
a
a
a
a
a
a
b
b
b
b
b
b
n
n
t
q
q
q
B
B
p
n
b
b
b
b
b
b
b
b
b
a
a
a
a
a
"}
(11,1,1) = {"
a
a
a
a
a
b
b
b
b
b
b
b
n
q
q
q
y
q
q
q
q
n
n
b
b
b
b
b
b
b
b
b
a
a
a
a
"}
(12,1,1) = {"
a
a
a
a
b
b
b
b
b
b
b
n
n
q
q
w
z
A
C
q
q
t
p
v
b
b
b
b
b
b
b
b
a
a
a
a
"}
(13,1,1) = {"
a
a
a
a
b
b
b
b
e
h
c
n
q
q
q
x
q
q
q
q
q
q
q
v
v
p
n
b
b
b
b
b
b
a
a
a
"}
(14,1,1) = {"
a
a
a
a
b
b
c
c
f
i
c
n
q
q
q
q
q
q
q
q
q
q
q
n
P
S
n
b
b
b
b
b
b
a
a
a
"}
(15,1,1) = {"
a
a
a
a
b
b
c
d
c
j
m
o
r
q
q
q
q
q
q
q
q
q
q
o
q
q
n
b
b
b
b
b
b
a
a
a
"}
(16,1,1) = {"
a
a
a
a
b
b
c
c
d
c
c
n
q
q
q
q
q
q
q
q
q
q
n
n
q
q
n
b
b
b
b
b
b
a
a
a
"}
(17,1,1) = {"
a
a
a
a
b
b
b
c
c
c
b
n
n
t
q
q
q
q
q
q
q
I
n
q
q
q
p
b
b
b
b
b
b
a
a
a
"}
(18,1,1) = {"
a
a
a
a
b
b
b
b
b
b
b
p
n
s
n
q
q
q
q
q
q
J
n
q
q
T
n
b
b
b
b
b
b
a
a
a
"}
(19,1,1) = {"
a
a
a
b
b
b
b
b
b
b
b
b
s
u
o
q
q
q
q
q
q
n
n
o
n
n
n
b
b
b
b
g
b
a
a
a
"}
(20,1,1) = {"
a
a
a
b
b
b
b
b
b
b
b
b
n
n
s
q
q
q
q
t
n
n
q
q
q
n
b
b
b
b
b
b
b
a
a
a
"}
(21,1,1) = {"
a
a
a
b
b
b
b
b
b
b
b
b
s
u
o
q
q
q
q
n
n
t
q
q
Q
p
b
b
b
b
b
b
b
a
a
a
"}
(22,1,1) = {"
a
a
a
b
b
b
b
b
c
g
b
b
p
s
n
s
q
q
q
n
q
q
q
q
R
n
b
b
b
b
b
b
b
a
a
a
"}
(23,1,1) = {"
a
a
a
a
b
b
b
b
g
k
b
b
b
n
u
o
q
q
q
o
q
q
q
q
n
n
b
b
b
b
b
b
b
a
a
a
"}
(24,1,1) = {"
a
a
a
a
b
b
b
b
b
b
b
b
b
v
v
v
n
p
D
n
q
q
q
q
p
b
b
b
b
b
b
b
b
a
a
a
"}
(25,1,1) = {"
a
a
a
a
b
b
b
b
b
b
b
b
b
b
b
b
b
n
n
p
v
K
M
O
p
b
b
b
b
b
b
b
a
a
a
a
"}
(26,1,1) = {"
a
a
a
a
b
b
b
b
b
b
b
b
b
b
b
b
b
b
E
F
v
v
p
n
n
b
b
b
b
b
b
b
a
a
a
a
"}
(27,1,1) = {"
a
a
a
a
b
b
b
b
b
b
b
b
b
b
b
b
b
b
b
G
F
L
N
b
b
b
b
b
b
b
b
a
a
a
a
a
"}
(28,1,1) = {"
a
a
a
a
b
b
b
b
b
b
b
b
b
b
b
b
b
b
b
b
H
b
b
b
b
b
b
b
b
b
a
a
a
a
a
a
"}
(29,1,1) = {"
a
a
a
a
a
b
b
b
b
b
b
b
b
b
b
b
c
b
b
b
b
b
b
b
b
b
b
b
b
b
a
a
a
a
a
a
"}
(30,1,1) = {"
a
a
a
a
a
a
b
b
b
b
b
b
b
b
b
g
g
c
b
b
b
b
b
b
b
b
b
b
a
a
a
a
a
a
a
a
"}
(31,1,1) = {"
a
a
a
a
a
a
a
b
b
b
b
b
b
b
b
c
g
k
k
b
b
b
k
b
b
b
b
a
a
a
a
a
a
a
a
a
"}
(32,1,1) = {"
a
a
a
a
a
a
a
b
b
b
b
b
b
b
b
b
b
b
b
b
b
b
g
b
b
b
b
a
a
a
a
a
a
a
a
a
"}
(33,1,1) = {"
a
a
a
a
a
a
a
a
b
b
b
b
b
b
b
b
b
b
b
b
b
b
b
b
b
b
a
a
a
a
a
a
a
a
a
a
"}
(34,1,1) = {"
a
a
a
a
a
a
a
a
a
a
b
b
b
b
b
b
b
b
b
b
b
b
b
b
b
a
a
a
a
a
a
a
a
a
a
a
"}
(35,1,1) = {"
a
a
a
a
a
a
a
a
a
a
a
a
a
b
b
b
b
b
b
b
b
b
a
a
a
a
a
a
a
a
a
a
a
a
a
a
"}
(36,1,1) = {"
a
a
a
a
a
a
a
a
a
a
a
a
a
a
a
a
a
a
a
a
a
a
a
a
a
a
a
a
a
a
a
a
a
a
a
a
"}
