"a" = (/turf/closed/mineral/snowmountain/cavern/icemoon,/area/icemoon/underground/unexplored)
"b" = (/turf/closed/mineral/random/snow,/area/icemoon/underground/unexplored)
"c" = (/turf/open/misc/asteroid/snow/icemoon,/area/icemoon/underground/unexplored)
"d" = (/obj/structure/flora/bush/snow/style_5,/turf/open/misc/asteroid/snow/icemoon,/area/icemoon/underground/unexplored)
"e" = (/turf/template_noop,/area/template_noop)
"f" = (/turf/open/floor/cult,/area/icemoon/underground/unexplored)
"g" = (/obj/item/bodypart/head/golem/cult,/obj/item/bodypart/l_arm/golem/cult{pixel_x = 7; pixel_y = -3},/obj/effect/decal/cleanable/blood/old,/turf/open/misc/asteroid/snow/icemoon,/area/icemoon/underground/unexplored)
"h" = (/obj/item/bodypart/chest/golem/cult{pixel_x = -7; pixel_y = 6},/obj/item/bodypart/l_leg/golem/cult,/obj/effect/decal/cleanable/blood/old,/turf/open/misc/asteroid/snow/icemoon,/area/icemoon/underground/unexplored)
"i" = (/obj/structure/flora/bush/snow/style_random,/turf/open/misc/asteroid/snow/icemoon,/area/icemoon/underground/unexplored)
"j" = (/turf/closed/wall/mineral/cult,/area/icemoon/underground/unexplored)
"k" = (/obj/item/flashlight/lantern{on = 1},/turf/open/misc/asteroid/snow/icemoon,/area/icemoon/underground/unexplored)
"l" = (/obj/item/melee/cultblade/dagger,/obj/effect/decal/cleanable/blood/old,/turf/open/misc/asteroid/snow/icemoon,/area/icemoon/underground/unexplored)
"m" = (/obj/effect/decal/cleanable/blood/old,/turf/open/misc/asteroid/snow/icemoon,/area/icemoon/underground/unexplored)
"n" = (/obj/structure/girder/cult,/turf/open/misc/asteroid/snow/icemoon,/area/icemoon/underground/unexplored)
"o" = (/obj/structure/flora/bush/snow/style_3,/turf/open/misc/asteroid/snow/icemoon,/area/icemoon/underground/unexplored)
"p" = (/obj/effect/decal/cleanable/blood/old,/turf/open/floor/cult,/area/icemoon/underground/unexplored)
"q" = (/turf/closed/wall/mineral/cult,/area/icemoon/surface/dorf_chaos)
"r" = (/obj/structure/mineral_door/stone,/turf/open/floor/cult,/area/icemoon/surface/dorf_chaos)
"s" = (/obj/effect/forcefield/cult,/turf/closed/wall/mineral/cult,/area/icemoon/surface/dorf_chaos)
"t" = (/turf/open/floor/cult,/area/icemoon/surface/dorf_chaos)
"u" = (/obj/effect/decal/cleanable/blood/old,/turf/open/floor/cult,/area/icemoon/surface/dorf_chaos)
"v" = (/obj/effect/temp_visual/cult/sparks,/turf/closed/wall/mineral/cult,/area/icemoon/surface/dorf_chaos)
"w" = (/obj/item/flashlight/lantern{on = 1},/turf/open/floor/cult,/area/icemoon/surface/dorf_chaos)
"x" = (/obj/effect/mob_spawn/ghost_role/human/dwarf_dorm/chaos,/obj/structure/bed,/obj/item/bedsheet/cult,/turf/open/floor/cult,/area/icemoon/surface/dorf_chaos)
"y" = (/obj/structure/girder/cult,/turf/open/floor/cult,/area/icemoon/surface/dorf_chaos)
"z" = (/obj/structure/table/stone,/obj/item/food/grown/mushroom/plumphelmet{pixel_x = 7; pixel_y = 8},/obj/item/food/grown/mushroom/plumphelmet{pixel_x = -3; pixel_y = 6},/obj/item/reagent_containers/food/drinks/wooden_mug{pixel_x = 1; pixel_y = 2},/turf/open/floor/cult,/area/icemoon/surface/dorf_chaos)
"A" = (/obj/structure/chair/stone{dir = 8},/turf/open/floor/cult,/area/icemoon/surface/dorf_chaos)
"B" = (/obj/structure/chair/stone{dir = 4},/turf/open/floor/cult,/area/icemoon/surface/dorf_chaos)
"C" = (/obj/structure/table/stone,/obj/item/food/grown/mushroom/plumphelmet{pixel_x = 7; pixel_y = 8},/obj/item/food/grown/mushroom/plumphelmet{pixel_x = -3; pixel_y = 6},/obj/item/reagent_containers/food/drinks/wooden_mug{pixel_x = 6},/turf/open/floor/cult,/area/icemoon/surface/dorf_chaos)
"D" = (/obj/structure/table/stone,/obj/item/food/grown/mushroom/plumphelmet{pixel_x = 10},/obj/item/food/grown/mushroom/plumphelmet{pixel_x = -3; pixel_y = 6},/obj/item/food/grown/mushroom/plumphelmet{pixel_x = 7; pixel_y = 8},/obj/item/food/grown/mushroom/plumphelmet{pixel_x = 7; pixel_y = 8},/obj/item/reagent_containers/food/drinks/wooden_mug{pixel_x = 1; pixel_y = 2},/turf/open/floor/cult,/area/icemoon/surface/dorf_chaos)
"E" = (/obj/structure/fermenting_barrel,/turf/open/floor/cult,/area/icemoon/surface/dorf_chaos)
"F" = (/obj/structure/chair/stone{dir = 1},/turf/open/floor/cult,/area/icemoon/surface/dorf_chaos)
"G" = (/obj/structure/closet/crate/stone,/obj/item/flashlight/lantern{pixel_x = -6; pixel_y = 3},/obj/item/flashlight/lantern{pixel_x = 7; pixel_y = 5},/obj/item/flashlight/lantern{pixel_y = 9},/obj/item/flashlight/flare/culttorch,/turf/open/floor/cult,/area/icemoon/surface/dorf_chaos)
"H" = (/obj/item/stack/ore/glass{amount = 30},/turf/open/misc/asteroid/snow/icemoon,/area/icemoon/surface/dorf_chaos)
"I" = (/obj/item/grown/log/tree,/obj/item/grown/log/tree,/turf/open/misc/asteroid/snow/icemoon,/area/icemoon/surface/dorf_chaos)
"J" = (/obj/item/grown/log/tree,/obj/item/grown/log/tree,/obj/structure/flora/bush/snow/style_random,/turf/open/misc/asteroid/snow/icemoon,/area/icemoon/surface/dorf_chaos)
"K" = (/obj/item/flashlight/lantern{on = 1},/turf/open/misc/asteroid/snow/icemoon,/area/icemoon/surface/dorf_chaos)
"L" = (/obj/structure/closet/crate/stone,/obj/item/pestle{pixel_x = 3; pixel_y = 4},/obj/item/kitchen/rollingpin,/obj/item/reagent_containers/glass/mortar,/obj/item/knife,/turf/open/floor/cult,/area/icemoon/surface/dorf_chaos)
"M" = (/obj/structure/closet/crate/stone,/obj/item/reagent_containers/glass/bucket/wooden{pixel_x = -3},/obj/item/reagent_containers/glass/bucket/wooden{pixel_x = 8; pixel_y = -1},/obj/item/reagent_containers/glass/bucket/wooden{pixel_y = 8},/turf/open/floor/cult,/area/icemoon/surface/dorf_chaos)
"N" = (/obj/machinery/smelter,/turf/open/floor/cult,/area/icemoon/surface/dorf_chaos)
"O" = (/obj/structure/water_source/puddle,/turf/open/misc/asteroid/snow/icemoon,/area/icemoon/surface/dorf_chaos)
"P" = (/obj/structure/table/stone,/obj/item/reagent_containers/molten_container/crucible{pixel_x = 6; pixel_y = 1},/obj/item/stack/sheet/mineral/clay{amount = 10},/turf/open/floor/cult,/area/icemoon/surface/dorf_chaos)
"Q" = (/obj/machinery/anvil,/obj/item/book/granter/crafting_recipe/dwarf{pixel_x = -6; pixel_y = 3},/turf/open/floor/cult,/area/icemoon/surface/dorf_chaos)
"R" = (/obj/structure/table/stone,/obj/item/cultivator/rake{pixel_x = 7; pixel_y = -2},/obj/item/hatchet/wooden{pixel_x = -4; pixel_y = 7},/turf/open/floor/cult,/area/icemoon/surface/dorf_chaos)
"S" = (/obj/structure/closet/crate/stone,/obj/item/dwarf_tool,/obj/item/melee/smith_hammer,/obj/item/melee/smith_hammer,/turf/open/floor/cult,/area/icemoon/surface/dorf_chaos)
"T" = (/obj/structure/closet/crate/stone,/obj/item/reagent_containers/molten_container/smelt_mold/armour,/obj/item/reagent_containers/molten_container/smelt_mold/bar,/obj/item/reagent_containers/molten_container/smelt_mold/helmet,/obj/item/reagent_containers/molten_container/smelt_mold/knife,/obj/item/reagent_containers/molten_container/smelt_mold/pickaxe,/obj/item/reagent_containers/molten_container/smelt_mold/shovel,/obj/item/reagent_containers/molten_container/smelt_mold/sword,/obj/item/reagent_containers/molten_container/smelt_mold/war_hammer,/turf/open/floor/cult,/area/icemoon/surface/dorf_chaos)
"U" = (/obj/structure/table/stone,/obj/item/shovel{pixel_x = 8; pixel_y = -5},/obj/item/shovel{pixel_y = 1},/obj/item/flashlight/lantern{on = 1},/turf/open/floor/cult,/area/icemoon/surface/dorf_chaos)
"V" = (/obj/structure/table/stone,/obj/item/pickaxe{pixel_x = 2; pixel_y = -1},/obj/item/pickaxe{pixel_x = 4; pixel_y = 4},/turf/open/floor/cult,/area/icemoon/surface/dorf_chaos)
"W" = (/obj/item/seeds/glowshroom,/obj/item/seeds/glowshroom,/obj/item/seeds/glowshroom,/obj/item/seeds/glowshroom,/obj/item/seeds/glowshroom,/obj/item/seeds/tower,/obj/item/seeds/tower,/obj/item/seeds/tower,/obj/item/seeds/tower,/obj/item/seeds/tower,/obj/item/seeds/wheat,/obj/item/seeds/wheat,/obj/item/seeds/wheat,/obj/item/seeds/wheat,/obj/item/seeds/wheat,/obj/item/seeds/cotton,/obj/item/seeds/cotton,/obj/item/seeds/cotton,/obj/item/seeds/cotton,/obj/item/seeds/cotton,/obj/structure/closet/crate/stone,/turf/open/misc/asteroid/snow/icemoon,/area/icemoon/surface/dorf_chaos)

(1,1,1) = {"
eeeeeeeeeeeeeeeeeeeeeeeeeeeeeeeeeeee
eeeeeeeeeeeeeeeeeeeeeeeeeeeeeeeeeeee
eeeeeeeeeeeeeeeeeeeeeeeeeeeeeeeeeeee
eeeeeeeeeeeeeeeeeeaaaaeeeeeeeeeeeeee
eeeeeeeeeeebbbbbaaaaaaaabbbbeeeeeeee
eeeeeeeeeebbbbbbbaaaaaabbbbbbeeeeeee
eeeeeeeebbbbbcdcbbbbabbbbbbbbbeeeeee
eeeeeebbbbbbbcfccbbbbbbbbbbbbbbbeeee
eeeeebbbbbabghcfibbbbijabbbbbbbbbeee
eeeebbbbbbaaklmccbbbbjnabbbbbbbbbeee
eeebbbabbaaacopcbbbbbaaaabbbbabbbbee
eeebbaabbbaqqqrqqsbbbbbabbbaaaabbbee
eeebbbbbbqqqttutqqvqvsbbbbaaaaabbbee
eebbbbbbqqttttttwvxqxvqybbaaaaabbbbe
eebbbcbbywtttttttqrvrqxybbbbaabbbbbe
ebbbinbbyttzAttttttttvryabbbbjibbbbe
ebbbcnbbytBCtttttttttttqaaabijjbbbbe
ebbbcabbsttDtttttttttttsqaabacnbbbbe
ebbbbbbbsEtFtttttttttttGqHabbbnbbbbe
ebbbbbbbqEtttttttttwqqrqsIJbbbbbbbbe
ebaabbbbqstttttttttqqtttyyIKbbbbbbbe
ebbnibbbbqqwttttLMqqwtttNyObbbbbbbbe
eebjabbbbbqstttqqqqtttttPsWbbbnjbbee
eebbbncbbbbyyqrqttrtttttQqbaabbbbbee
eeebbjjnbbbayRttttqtSTqssqaaabbbbbee
eeeebbanbbbbsUtttVqqsqqbaabaaabbbeee
eeeebbaabbabqqqqsqqbaaaaaabbabbbeeee
eeeeeabbbaabbbbbbbbbbbbaaabbbbeeeeee
eeeeeeebbbabbbbbaaaabbbbabbbbeeeeeee
eeeeeeeeebbbbaaaaaaabbbbbbbbbeeeeeee
eeeeeeeeebbbaaaaaaabbbbbbbbeeeeeeeee
eeeeeeeeeebbbbbabbjbbbbbbbeeeeeeeeee
eeeeeeeeeeeebbbbbbbbbbbbeeeeeeeeeeee
eeeeeeeeeeeeeeeeeeeeeeeeeeeeeeeeeeee
eeeeeeeeeeeeeeeeeeeeeeeeeeeeeeeeeeee
eeeeeeeeeeeeeeeeeeeeeeeeeeeeeeeeeeee
"}
