//MAP CONVERTED BY dmm2tgm.py THIS HEADER COMMENT PREVENTS RECONVERSION, DO NOT REMOVE
"a" = (
/turf/closed/mineral/snowmountain/cavern/icemoon,
/area/icemoon/underground/unexplored)
"b" = (
/turf/closed/mineral/random/snow,
/area/icemoon/underground/unexplored)
"c" = (
/turf/open/misc/asteroid/snow/icemoon,
/area/icemoon/underground/unexplored)
"d" = (
/obj/structure/flora/bush/snow/style_5,
/turf/open/misc/asteroid/snow/icemoon,
/area/icemoon/underground/unexplored)
"e" = (
/turf/template_noop,
/area/template_noop)
"f" = (
/turf/open/floor/cult{
	initial_gas_mix = "ICEMOON_ATMOS"
	},
/area/icemoon/underground/unexplored)
"g" = (
/obj/item/bodypart/head/golem/cult,
/obj/item/bodypart/arm/left/golem/cult{
	pixel_x = 7;
	pixel_y = -3
	},
/obj/effect/decal/cleanable/blood/old,
/turf/open/misc/asteroid/snow/icemoon,
/area/icemoon/underground/unexplored)
"h" = (
/obj/item/bodypart/chest/golem/cult{
	pixel_x = -7;
	pixel_y = 6
	},
/obj/item/bodypart/leg/left/golem/cult,
/obj/effect/decal/cleanable/blood/old,
/turf/open/misc/asteroid/snow/icemoon,
/area/icemoon/underground/unexplored)
"i" = (
/obj/structure/flora/bush/snow/style_random,
/turf/open/misc/asteroid/snow/icemoon,
/area/icemoon/underground/unexplored)
"j" = (
/turf/closed/wall/mineral/cult,
/area/icemoon/underground/unexplored)
"k" = (
/obj/item/flashlight/lantern{
	on = 1
	},
/turf/open/misc/asteroid/snow/icemoon,
/area/icemoon/underground/unexplored)
"l" = (
/obj/item/melee/cultblade/dagger,
/obj/effect/decal/cleanable/blood/old,
/turf/open/misc/asteroid/snow/icemoon,
/area/icemoon/underground/unexplored)
"m" = (
/obj/effect/decal/cleanable/blood/old,
/turf/open/misc/asteroid/snow/icemoon,
/area/icemoon/underground/unexplored)
"n" = (
/obj/structure/girder/cult,
/turf/open/misc/asteroid/snow/icemoon,
/area/icemoon/underground/unexplored)
"o" = (
/obj/structure/flora/bush/snow/style_3,
/turf/open/misc/asteroid/snow/icemoon,
/area/icemoon/underground/unexplored)
"p" = (
/obj/effect/decal/cleanable/blood/old,
/turf/open/floor/cult{
	initial_gas_mix = "ICEMOON_ATMOS"
	},
/area/icemoon/underground/unexplored)
"q" = (
/turf/closed/wall/mineral/cult,
/area/icemoon/surface/dorf_chaos)
"r" = (
/obj/structure/mineral_door/stone,
/turf/open/floor/cult{
	initial_gas_mix = "ICEMOON_ATMOS"
	},
/area/icemoon/surface/dorf_chaos)
"s" = (
/obj/effect/forcefield/cult,
/turf/closed/wall/mineral/cult,
/area/icemoon/surface/dorf_chaos)
"t" = (
/turf/open/floor/cult{
	initial_gas_mix = "ICEMOON_ATMOS"
	},
/area/icemoon/surface/dorf_chaos)
"u" = (
/obj/effect/decal/cleanable/blood/old,
/turf/open/floor/cult{
	initial_gas_mix = "ICEMOON_ATMOS"
	},
/area/icemoon/surface/dorf_chaos)
"v" = (
/obj/effect/temp_visual/cult/sparks,
/turf/closed/wall/mineral/cult,
/area/icemoon/surface/dorf_chaos)
"w" = (
/obj/item/flashlight/lantern{
	on = 1
	},
/turf/open/floor/cult{
	initial_gas_mix = "ICEMOON_ATMOS"
	},
/area/icemoon/surface/dorf_chaos)
"x" = (
/obj/effect/mob_spawn/ghost_role/human/dwarf_dorm/chaos,
/obj/structure/bed,
/obj/item/bedsheet/cult,
/turf/open/floor/cult{
	initial_gas_mix = "ICEMOON_ATMOS"
	},
/area/icemoon/surface/dorf_chaos)
"y" = (
/obj/structure/girder/cult,
/turf/open/floor/cult{
	initial_gas_mix = "ICEMOON_ATMOS"
	},
/area/icemoon/surface/dorf_chaos)
"z" = (
/obj/structure/table/stone,
/obj/item/food/grown/mushroom/plumphelmet{
	pixel_x = 7;
	pixel_y = 8
	},
/obj/item/food/grown/mushroom/plumphelmet{
	pixel_x = -3;
	pixel_y = 6
	},
/obj/item/reagent_containers/cup/glass/wooden_mug{
	pixel_x = 1;
	pixel_y = 2
	},
/turf/open/floor/cult{
	initial_gas_mix = "ICEMOON_ATMOS"
	},
/area/icemoon/surface/dorf_chaos)
"A" = (
/obj/structure/chair/stone{
	dir = 8
	},
/turf/open/floor/cult{
	initial_gas_mix = "ICEMOON_ATMOS"
	},
/area/icemoon/surface/dorf_chaos)
"B" = (
/obj/structure/chair/stone{
	dir = 4
	},
/turf/open/floor/cult{
	initial_gas_mix = "ICEMOON_ATMOS"
	},
/area/icemoon/surface/dorf_chaos)
"C" = (
/obj/structure/table/stone,
/obj/item/food/grown/mushroom/plumphelmet{
	pixel_x = 7;
	pixel_y = 8
	},
/obj/item/food/grown/mushroom/plumphelmet{
	pixel_x = -3;
	pixel_y = 6
	},
/obj/item/reagent_containers/cup/glass/wooden_mug{
	pixel_x = 6
	},
/turf/open/floor/cult{
	initial_gas_mix = "ICEMOON_ATMOS"
	},
/area/icemoon/surface/dorf_chaos)
"D" = (
/obj/structure/table/stone,
/obj/item/food/grown/mushroom/plumphelmet{
	pixel_x = 10
	},
/obj/item/food/grown/mushroom/plumphelmet{
	pixel_x = -3;
	pixel_y = 6
	},
/obj/item/food/grown/mushroom/plumphelmet{
	pixel_x = 7;
	pixel_y = 8
	},
/obj/item/food/grown/mushroom/plumphelmet{
	pixel_x = 7;
	pixel_y = 8
	},
/obj/item/reagent_containers/cup/glass/wooden_mug{
	pixel_x = 1;
	pixel_y = 2
	},
/turf/open/floor/cult{
	initial_gas_mix = "ICEMOON_ATMOS"
	},
/area/icemoon/surface/dorf_chaos)
"E" = (
/obj/structure/fermenting_barrel,
/turf/open/floor/cult{
	initial_gas_mix = "ICEMOON_ATMOS"
	},
/area/icemoon/surface/dorf_chaos)
"F" = (
/obj/structure/chair/stone{
	dir = 1
	},
/turf/open/floor/cult{
	initial_gas_mix = "ICEMOON_ATMOS"
	},
/area/icemoon/surface/dorf_chaos)
"G" = (
/obj/structure/closet/crate/stone,
/obj/item/flashlight/lantern{
	pixel_x = -6;
	pixel_y = 3
	},
/obj/item/flashlight/lantern{
	pixel_x = 7;
	pixel_y = 5
	},
/obj/item/flashlight/lantern{
	pixel_y = 9
	},
/obj/item/flashlight/flare/culttorch,
/turf/open/floor/cult{
	initial_gas_mix = "ICEMOON_ATMOS"
	},
/area/icemoon/surface/dorf_chaos)
"H" = (
/obj/item/stack/ore/glass{
	amount = 30
	},
/turf/open/misc/asteroid/snow/icemoon,
/area/icemoon/surface/dorf_chaos)
"I" = (
/obj/item/grown/log/tree,
/obj/item/grown/log/tree,
/turf/open/misc/asteroid/snow/icemoon,
/area/icemoon/surface/dorf_chaos)
"J" = (
/obj/item/grown/log/tree,
/obj/item/grown/log/tree,
/obj/structure/flora/bush/snow/style_random,
/turf/open/misc/asteroid/snow/icemoon,
/area/icemoon/surface/dorf_chaos)
"K" = (
/obj/item/flashlight/lantern{
	on = 1
	},
/turf/open/misc/asteroid/snow/icemoon,
/area/icemoon/surface/dorf_chaos)
"L" = (
/obj/structure/closet/crate/stone,
/obj/item/pestle{
	pixel_x = 3;
	pixel_y = 4
	},
/obj/item/kitchen/rollingpin,
/obj/item/reagent_containers/cup/mortar,
/obj/item/knife,
/turf/open/floor/cult{
	initial_gas_mix = "ICEMOON_ATMOS"
	},
/area/icemoon/surface/dorf_chaos)
"M" = (
/obj/structure/closet/crate/stone,
/obj/item/reagent_containers/cup/bucket/wooden{
	pixel_x = -3
	},
/obj/item/reagent_containers/cup/bucket/wooden{
	pixel_x = 8;
	pixel_y = -1
	},
/obj/item/reagent_containers/cup/bucket/wooden{
	pixel_y = 8
	},
/turf/open/floor/cult{
	initial_gas_mix = "ICEMOON_ATMOS"
	},
/area/icemoon/surface/dorf_chaos)
"N" = (
/obj/machinery/smelter,
/turf/open/floor/cult{
	initial_gas_mix = "ICEMOON_ATMOS"
	},
/area/icemoon/surface/dorf_chaos)
"O" = (
/obj/structure/water_source/puddle,
/turf/open/misc/asteroid/snow/icemoon,
/area/icemoon/surface/dorf_chaos)
"P" = (
/obj/structure/table/stone,
/obj/item/reagent_containers/molten_container/crucible{
	pixel_x = 6;
	pixel_y = 1
	},
/obj/item/stack/sheet/mineral/clay{
	amount = 10
	},
/turf/open/floor/cult{
	initial_gas_mix = "ICEMOON_ATMOS"
	},
/area/icemoon/surface/dorf_chaos)
"Q" = (
/obj/machinery/anvil,
/obj/item/book/granter/crafting_recipe/dwarf{
	pixel_x = -6;
	pixel_y = 3
	},
/turf/open/floor/cult{
	initial_gas_mix = "ICEMOON_ATMOS"
	},
/area/icemoon/surface/dorf_chaos)
"R" = (
/obj/structure/table/stone,
/obj/item/cultivator/rake{
	pixel_x = 7;
	pixel_y = -2
	},
/obj/item/hatchet/wooden{
	pixel_x = -4;
	pixel_y = 7
	},
/turf/open/floor/cult{
	initial_gas_mix = "ICEMOON_ATMOS"
	},
/area/icemoon/surface/dorf_chaos)
"S" = (
/obj/structure/closet/crate/stone,
/obj/item/dwarf_tool,
/obj/item/melee/smith_hammer,
/obj/item/melee/smith_hammer,
/turf/open/floor/cult{
	initial_gas_mix = "ICEMOON_ATMOS"
	},
/area/icemoon/surface/dorf_chaos)
"T" = (
/obj/structure/closet/crate/stone,
/obj/item/reagent_containers/molten_container/smelt_mold/armour,
/obj/item/reagent_containers/molten_container/smelt_mold/bar,
/obj/item/reagent_containers/molten_container/smelt_mold/helmet,
/obj/item/reagent_containers/molten_container/smelt_mold/knife,
/obj/item/reagent_containers/molten_container/smelt_mold/pickaxe,
/obj/item/reagent_containers/molten_container/smelt_mold/shovel,
/obj/item/reagent_containers/molten_container/smelt_mold/sword,
/obj/item/reagent_containers/molten_container/smelt_mold/war_hammer,
/turf/open/floor/cult{
	initial_gas_mix = "ICEMOON_ATMOS"
	},
/area/icemoon/surface/dorf_chaos)
"U" = (
/obj/structure/table/stone,
/obj/item/shovel{
	pixel_x = 8;
	pixel_y = -5
	},
/obj/item/shovel{
	pixel_y = 1
	},
/obj/item/flashlight/lantern{
	on = 1
	},
/turf/open/floor/cult{
	initial_gas_mix = "ICEMOON_ATMOS"
	},
/area/icemoon/surface/dorf_chaos)
"V" = (
/obj/structure/table/stone,
/obj/item/pickaxe{
	pixel_x = 2;
	pixel_y = -1
	},
/obj/item/pickaxe{
	pixel_x = 4;
	pixel_y = 4
	},
/turf/open/floor/cult{
	initial_gas_mix = "ICEMOON_ATMOS"
	},
/area/icemoon/surface/dorf_chaos)
"W" = (
/obj/item/seeds/glowshroom,
/obj/item/seeds/glowshroom,
/obj/item/seeds/glowshroom,
/obj/item/seeds/glowshroom,
/obj/item/seeds/glowshroom,
/obj/item/seeds/tower,
/obj/item/seeds/tower,
/obj/item/seeds/tower,
/obj/item/seeds/tower,
/obj/item/seeds/tower,
/obj/item/seeds/wheat,
/obj/item/seeds/wheat,
/obj/item/seeds/wheat,
/obj/item/seeds/wheat,
/obj/item/seeds/wheat,
/obj/item/seeds/cotton,
/obj/item/seeds/cotton,
/obj/item/seeds/cotton,
/obj/item/seeds/cotton,
/obj/item/seeds/cotton,
/obj/structure/closet/crate/stone,
/turf/open/misc/asteroid/snow/icemoon,
/area/icemoon/surface/dorf_chaos)

(1,1,1) = {"
e
e
e
e
e
e
e
e
e
e
e
e
e
e
e
e
e
e
e
e
e
e
e
e
e
e
e
e
e
e
e
e
e
e
e
e
"}
(2,1,1) = {"
e
e
e
e
e
e
e
e
e
e
e
e
e
e
e
b
b
b
b
b
b
b
e
e
e
e
e
e
e
e
e
e
e
e
e
e
"}
(3,1,1) = {"
e
e
e
e
e
e
e
e
e
e
e
e
e
b
b
b
b
b
b
b
a
b
b
b
e
e
e
e
e
e
e
e
e
e
e
e
"}
(4,1,1) = {"
e
e
e
e
e
e
e
e
e
e
b
b
b
b
b
b
b
b
b
b
a
n
j
b
b
e
e
e
e
e
e
e
e
e
e
e
"}
(5,1,1) = {"
e
e
e
e
e
e
e
e
e
b
b
b
b
b
b
i
c
c
b
b
b
i
a
b
b
b
b
e
e
e
e
e
e
e
e
e
"}
(6,1,1) = {"
e
e
e
e
e
e
e
e
b
b
b
a
b
b
c
n
n
a
b
b
b
b
b
n
j
b
b
a
e
e
e
e
e
e
e
e
"}
(7,1,1) = {"
e
e
e
e
e
e
e
b
b
b
a
a
b
b
b
b
b
b
b
b
b
b
b
c
j
a
a
b
e
e
e
e
e
e
e
e
"}
(8,1,1) = {"
e
e
e
e
e
e
e
b
b
b
b
b
b
b
b
b
b
b
b
b
b
b
b
b
n
n
a
b
b
e
e
e
e
e
e
e
"}
(9,1,1) = {"
e
e
e
e
e
e
b
b
b
b
b
b
b
q
y
y
y
s
s
q
q
b
b
b
b
b
b
b
b
e
e
e
e
e
e
e
"}
(10,1,1) = {"
e
e
e
e
e
e
b
b
b
b
a
b
q
q
w
t
t
t
E
E
s
q
b
b
b
b
b
a
b
b
b
e
e
e
e
e
"}
(11,1,1) = {"
e
e
e
e
e
b
b
b
a
a
a
a
q
t
t
t
B
t
t
t
t
q
q
b
b
b
a
a
a
b
b
b
e
e
e
e
"}
(12,1,1) = {"
e
e
e
e
b
b
b
b
b
a
a
q
q
t
t
z
C
D
F
t
t
w
s
y
a
b
b
b
b
b
b
b
e
e
e
e
"}
(13,1,1) = {"
e
e
e
e
b
b
b
b
g
k
c
q
t
t
t
A
t
t
t
t
t
t
t
y
y
s
q
b
b
b
a
b
b
e
e
e
"}
(14,1,1) = {"
e
e
e
e
b
b
c
c
h
l
o
q
t
t
t
t
t
t
t
t
t
t
t
q
R
U
q
b
b
a
a
b
b
e
e
e
"}
(15,1,1) = {"
e
e
e
e
b
b
d
f
c
m
p
r
u
t
t
t
t
t
t
t
t
t
t
r
t
t
q
b
b
a
a
b
b
e
e
e
"}
(16,1,1) = {"
e
e
e
e
b
b
c
c
f
c
c
q
t
t
t
t
t
t
t
t
t
t
q
q
t
t
q
b
b
a
a
a
b
e
e
e
"}
(17,1,1) = {"
e
e
e
e
a
b
b
c
i
c
b
q
q
w
t
t
t
t
t
t
t
L
q
t
t
t
s
b
a
a
a
b
b
e
e
e
"}
(18,1,1) = {"
e
e
e
e
a
a
b
b
b
b
b
s
q
v
q
t
t
t
t
t
t
M
q
t
t
V
q
b
a
a
a
b
b
e
e
e
"}
(19,1,1) = {"
e
e
e
a
a
a
b
b
b
b
b
b
v
x
r
t
t
t
t
t
t
q
q
r
q
q
q
b
a
a
a
j
b
e
e
e
"}
(20,1,1) = {"
e
e
e
a
a
a
b
b
b
b
b
b
q
q
v
t
t
t
t
w
q
q
t
t
t
q
b
b
a
a
b
b
b
e
e
e
"}
(21,1,1) = {"
e
e
e
a
a
a
a
b
b
b
b
b
v
x
r
t
t
t
t
q
q
w
t
t
S
s
a
b
b
b
b
b
b
e
e
e
"}
(22,1,1) = {"
e
e
e
a
a
a
b
b
i
j
a
b
s
v
q
v
t
t
t
q
t
t
t
t
T
q
a
b
b
b
b
b
b
e
e
e
"}
(23,1,1) = {"
e
e
e
e
a
a
b
b
j
n
a
b
b
q
x
r
t
t
t
r
t
t
t
t
q
q
a
b
b
b
b
b
b
e
e
e
"}
(24,1,1) = {"
e
e
e
e
a
b
b
b
a
a
a
a
b
y
y
y
q
s
G
q
t
t
t
t
s
b
a
a
b
b
b
b
b
e
e
e
"}
(25,1,1) = {"
e
e
e
e
b
b
b
b
b
b
a
b
b
b
b
a
a
q
q
s
y
N
P
Q
s
a
a
a
a
b
b
b
e
e
e
e
"}
(26,1,1) = {"
e
e
e
e
b
b
b
b
b
b
b
b
b
b
b
b
a
a
H
I
y
y
s
q
q
a
a
a
b
b
b
b
e
e
e
e
"}
(27,1,1) = {"
e
e
e
e
b
b
b
b
b
b
b
b
a
a
b
b
a
a
a
J
I
O
W
b
a
b
b
b
b
b
b
e
e
e
e
e
"}
(28,1,1) = {"
e
e
e
e
b
b
b
b
b
b
b
a
a
a
b
b
b
b
b
b
K
b
b
a
a
a
b
b
b
b
e
e
e
e
e
e
"}
(29,1,1) = {"
e
e
e
e
e
b
b
b
b
b
b
a
a
a
a
b
i
a
b
b
b
b
b
a
a
a
a
b
b
b
e
e
e
e
e
e
"}
(30,1,1) = {"
e
e
e
e
e
e
b
b
b
b
a
a
a
a
a
j
j
c
b
b
b
b
b
b
b
a
b
b
e
e
e
e
e
e
e
e
"}
(31,1,1) = {"
e
e
e
e
e
e
e
b
b
b
b
a
a
a
b
i
j
n
n
b
b
b
n
b
b
b
b
e
e
e
e
e
e
e
e
e
"}
(32,1,1) = {"
e
e
e
e
e
e
e
b
b
b
b
b
b
b
b
b
b
b
b
b
b
b
j
b
b
b
b
e
e
e
e
e
e
e
e
e
"}
(33,1,1) = {"
e
e
e
e
e
e
e
e
b
b
b
b
b
b
b
b
b
b
b
b
b
b
b
b
b
b
e
e
e
e
e
e
e
e
e
e
"}
(34,1,1) = {"
e
e
e
e
e
e
e
e
e
e
b
b
b
b
b
b
b
b
b
b
b
b
b
b
b
e
e
e
e
e
e
e
e
e
e
e
"}
(35,1,1) = {"
e
e
e
e
e
e
e
e
e
e
e
e
e
b
b
b
b
b
b
b
b
b
e
e
e
e
e
e
e
e
e
e
e
e
e
e
"}
(36,1,1) = {"
e
e
e
e
e
e
e
e
e
e
e
e
e
e
e
e
e
e
e
e
e
e
e
e
e
e
e
e
e
e
e
e
e
e
e
e
"}
