//MAP CONVERTED BY dmm2tgm.py THIS HEADER COMMENT PREVENTS RECONVERSION, DO NOT REMOVE
"a" = (
/turf/closed/indestructible/riveted/hierophant,
/area/ruin/unpowered/hierophant)
"f" = (
/obj/effect/light_emitter{
	set_cap = 3;
	set_luminosity = 5
	},
/turf/open/indestructible/hierophant/two/icemoon,
/area/ruin/unpowered/hierophant)
"m" = (
/mob/living/simple_animal/hostile/megafauna/hierophant,
/turf/open/indestructible/hierophant/two/icemoon,
/area/ruin/unpowered/hierophant)
"o" = (
/turf/open/indestructible/hierophant/two/icemoon,
/area/ruin/unpowered/hierophant)
"q" = (
/turf/open/indestructible/hierophant/icemoon,
/area/ruin/unpowered/hierophant)
"O" = (
/obj/effect/light_emitter{
	set_cap = 3;
	set_luminosity = 5
	},
/turf/open/indestructible/hierophant/icemoon,
/area/ruin/unpowered/hierophant)

(1,1,1) = {"
a
a
a
q
q
q
q
a
a
a
a
a
a
a
a
a
q
q
q
q
a
a
a
"}
(2,1,1) = {"
a
q
q
q
q
q
q
q
q
q
q
O
q
q
q
q
q
q
q
q
q
q
a
"}
(3,1,1) = {"
a
q
q
q
O
O
q
q
q
a
q
q
q
a
q
q
q
O
O
q
q
q
a
"}
(4,1,1) = {"
q
q
q
q
q
q
q
q
q
q
q
q
q
q
q
q
q
q
q
q
q
q
q
"}
(5,1,1) = {"
q
q
O
q
a
a
q
O
q
q
q
O
q
q
q
O
q
a
a
q
O
q
q
"}
(6,1,1) = {"
q
q
O
q
a
a
q
O
q
q
q
O
q
q
q
O
q
a
a
q
O
q
q
"}
(7,1,1) = {"
q
q
q
q
q
q
o
o
o
o
o
o
o
o
o
o
o
q
q
q
q
q
q
"}
(8,1,1) = {"
a
q
q
q
O
O
o
o
o
a
o
o
o
a
o
o
o
O
O
q
q
q
a
"}
(9,1,1) = {"
a
q
q
q
q
q
o
o
o
o
o
f
o
o
o
o
o
q
q
q
q
q
a
"}
(10,1,1) = {"
a
q
a
q
q
q
o
a
o
o
o
o
o
o
o
a
o
q
q
q
a
q
a
"}
(11,1,1) = {"
a
q
q
q
q
q
o
o
o
o
o
o
o
o
o
o
o
q
q
q
q
q
a
"}
(12,1,1) = {"
a
O
q
q
O
O
o
o
f
o
o
m
o
o
f
o
o
O
O
q
q
O
a
"}
(13,1,1) = {"
a
q
q
q
q
q
o
o
o
o
o
o
o
o
o
o
o
q
q
q
q
q
a
"}
(14,1,1) = {"
a
q
a
q
q
q
o
a
o
o
o
o
o
o
o
a
o
q
q
q
a
q
a
"}
(15,1,1) = {"
a
q
q
q
q
q
o
o
o
o
o
f
o
o
o
o
o
q
q
q
q
q
a
"}
(16,1,1) = {"
a
q
q
q
O
O
o
o
o
a
o
o
o
a
o
o
o
O
O
q
q
q
a
"}
(17,1,1) = {"
q
q
q
q
q
q
o
o
o
o
o
o
o
o
o
o
o
q
q
q
q
q
q
"}
(18,1,1) = {"
q
q
O
q
a
a
q
O
q
q
q
O
q
q
q
O
q
a
a
q
O
q
q
"}
(19,1,1) = {"
q
q
O
q
a
a
q
O
q
q
q
O
q
q
q
O
q
a
a
q
O
q
q
"}
(20,1,1) = {"
q
q
q
q
q
q
q
q
q
q
q
q
q
q
q
q
q
q
q
q
q
q
q
"}
(21,1,1) = {"
a
q
q
q
O
O
q
q
q
a
q
q
q
a
q
q
q
O
O
q
q
q
a
"}
(22,1,1) = {"
a
q
q
q
q
q
q
q
q
q
q
O
q
q
q
q
q
q
q
q
q
q
a
"}
(23,1,1) = {"
a
a
a
q
q
q
q
a
a
a
a
a
a
a
a
a
q
q
q
q
a
a
a
"}
