"aa" = (/turf/closed/wall/mineral/plastitanium,/area/shuttle/arrival)
"ab" = (/obj/machinery/door/airlock/shuttle{name = "Arrival Shuttle Airlock"},/turf/open/floor/mineral/plastitanium,/area/shuttle/arrival)
"ac" = (/turf/closed/wall/mineral/titanium,/area/shuttle/arrival)
"ad" = (/obj/structure/closet/emcloset/anchored,/turf/open/floor/mineral/titanium/white,/area/shuttle/arrival)
"ae" = (/obj/effect/turf_decal/arrows{dir = 1; icon_state = "arrows"},/obj/machinery/light{dir = 4},/turf/open/floor/mineral/plastitanium,/area/shuttle/arrival)
"ag" = (/turf/template_noop,/area/template_noop)
"ai" = (/obj/effect/turf_decal/stripes{dir = 1},/turf/open/floor/mineral/plastitanium,/area/shuttle/arrival)
"aj" = (/turf/open/floor/mineral/plastitanium,/area/shuttle/arrival)
"ak" = (/obj/machinery/light{dir = 8},/obj/structure/chair/comfy/shuttle{dir = 4},/turf/open/floor/mineral/titanium/white,/area/shuttle/arrival)
"al" = (/turf/open/floor/mineral/titanium/white,/area/shuttle/arrival)
"am" = (/obj/item/kirbyplants/random,/obj/item/cardboard_cutout,/turf/open/floor/mineral/titanium/white,/area/shuttle/arrival)
"an" = (/obj/machinery/light{dir = 1},/obj/structure/chair/comfy/shuttle{dir = 4},/turf/open/floor/mineral/titanium/white,/area/shuttle/arrival)
"ao" = (/obj/machinery/light{dir = 4},/obj/structure/chair/comfy/shuttle{dir = 8},/turf/open/floor/mineral/titanium/white,/area/shuttle/arrival)
"ar" = (/obj/structure/chair/comfy/shuttle{dir = 8},/obj/item/radio,/turf/open/floor/mineral/titanium/white,/area/shuttle/arrival)
"at" = (/obj/structure/sign/nanotrasen,/turf/closed/wall/mineral/titanium,/area/shuttle/arrival)
"au" = (/obj/structure/chair/comfy/shuttle{dir = 4},/obj/machinery/status_display/evac{pixel_x = -32},/turf/open/floor/mineral/titanium/white,/area/shuttle/arrival)
"az" = (/obj/structure/chair/comfy/shuttle{dir = 4},/turf/open/floor/mineral/titanium/white,/area/shuttle/arrival)
"aA" = (/obj/machinery/requests_console{department = "Arrival shuttle"; name = "Arrivals Shuttle console"},/turf/closed/wall/mineral/titanium,/area/shuttle/arrival)
"aB" = (/obj/machinery/light{dir = 1},/obj/structure/chair/comfy/shuttle{dir = 8},/turf/open/floor/mineral/titanium/white,/area/shuttle/arrival)
"aD" = (/obj/item/megaphone,/obj/item/kirbyplants/random,/turf/open/floor/mineral/titanium/white,/area/shuttle/arrival)
"aF" = (/obj/structure/shuttle/engine/heater{dir = 4},/turf/open/floor/plating,/area/shuttle/arrival)
"aG" = (/obj/structure/chair/comfy/shuttle,/obj/item/bikehorn,/turf/open/floor/mineral/titanium/white,/area/shuttle/arrival)
"aH" = (/obj/machinery/door/airlock/shuttle{name = "Arrival Shuttle Airlock"},/obj/docking_port/mobile/arrivals{dir = 2; port_direction = 4; preferred_direction = 8},/turf/open/floor/mineral/plastitanium,/area/shuttle/arrival)
"aI" = (/obj/structure/chair/comfy/shuttle{dir = 8},/obj/machinery/newscaster{pixel_x = 32},/turf/open/floor/mineral/titanium/white,/area/shuttle/arrival)
"aK" = (/obj/machinery/newscaster{pixel_x = -32},/turf/open/floor/mineral/titanium/white,/area/shuttle/arrival)
"aM" = (/obj/structure/chair/comfy/shuttle,/turf/open/floor/mineral/titanium/white,/area/shuttle/arrival)
"aN" = (/obj/effect/turf_decal/arrows{dir = 1; icon_state = "arrows"},/obj/machinery/light{dir = 8},/turf/open/floor/mineral/plastitanium,/area/shuttle/arrival)
"aO" = (/obj/machinery/status_display/evac,/turf/closed/wall/mineral/titanium,/area/shuttle/arrival)
"aP" = (/obj/structure/chair/comfy/shuttle{dir = 4},/obj/machinery/light{dir = 8},/turf/open/floor/mineral/titanium/white,/area/shuttle/arrival)
"aQ" = (/obj/machinery/light{dir = 4},/obj/structure/closet/emcloset/anchored,/turf/open/floor/mineral/titanium/white,/area/shuttle/arrival)
"aR" = (/obj/structure/chair/comfy/shuttle{dir = 4},/obj/structure/window/reinforced{dir = 8},/turf/open/floor/mineral/titanium/white,/area/shuttle/arrival)
"aT" = (/obj/machinery/light{dir = 8},/turf/open/floor/mineral/titanium/white,/area/shuttle/arrival)
"aV" = (/obj/structure/toilet{dir = 1},/obj/structure/curtain,/obj/structure/window/reinforced{dir = 4},/obj/structure/window/reinforced{dir = 8},/turf/open/floor/mineral/titanium/white,/area/shuttle/arrival)
"aY" = (/obj/structure/chair/comfy/shuttle{dir = 8},/obj/machinery/status_display/evac{pixel_x = 32},/turf/open/floor/mineral/titanium/white,/area/shuttle/arrival)
"bb" = (/obj/machinery/vending/cola,/turf/open/floor/mineral/titanium/white,/area/shuttle/arrival)
"bg" = (/turf/template_noop,/area/shuttle/arrival)
"bi" = (/obj/structure/chair/comfy/shuttle{dir = 1},/turf/open/floor/mineral/titanium/white,/area/shuttle/arrival)
"bp" = (/obj/structure/window/reinforced{dir = 8},/obj/structure/chair/comfy/shuttle{dir = 4},/turf/open/floor/mineral/titanium/white,/area/shuttle/arrival)
"bz" = (/obj/structure/chair/comfy/shuttle{dir = 8},/obj/machinery/light{dir = 4},/turf/open/floor/mineral/titanium/white,/area/shuttle/arrival)
"bE" = (/obj/structure/chair/comfy/shuttle{dir = 8},/turf/open/floor/mineral/titanium/white,/area/shuttle/arrival)
"bG" = (/obj/effect/spawner/structure/window/shuttle,/turf/open/floor/plating,/area/shuttle/arrival)
"bL" = (/turf/closed/wall/mineral/plastitanium/nodiagonal,/area/shuttle/arrival)
"bP" = (/obj/structure/chair/comfy/shuttle{dir = 8},/obj/item/radio/intercom{dir = 4; name = "Station Intercom (General)"; pixel_x = 28},/turf/open/floor/mineral/titanium/white,/area/shuttle/arrival)
"bT" = (/obj/machinery/vending/cigarette,/turf/open/floor/mineral/titanium/white,/area/shuttle/arrival)
"bU" = (/obj/machinery/light{dir = 4},/obj/structure/chair/comfy/shuttle{dir = 1},/turf/open/floor/mineral/titanium/white,/area/shuttle/arrival)
"hm" = (/obj/structure/shuttle/engine/large{dir = 4},/turf/template_noop,/area/shuttle/arrival)
"hy" = (/obj/structure/chair/comfy/shuttle{dir = 1},/obj/item/radio,/turf/open/floor/mineral/titanium/white,/area/shuttle/arrival)
"pq" = (/obj/machinery/newscaster{pixel_y = 32},/obj/machinery/light{dir = 1},/turf/open/floor/mineral/titanium/white,/area/shuttle/arrival)
"pS" = (/obj/structure/chair/comfy/shuttle,/obj/item/radio/intercom{dir = 4; name = "Station Intercom (General)"; pixel_y = 27},/turf/open/floor/mineral/titanium/white,/area/shuttle/arrival)
"HW" = (/obj/machinery/status_display/evac{pixel_x = -32},/turf/open/floor/mineral/titanium/white,/area/shuttle/arrival)
"Pt" = (/obj/machinery/status_display/evac{pixel_x = 32},/turf/open/floor/mineral/titanium/white,/area/shuttle/arrival)

(1,1,1) = {"
agagagagagagagacabataHacabatabacagagagagagagag
agagacbGbGbGacacaiacaiacaiacaiacbLaaagagagagag
agacacamaRadbEacaNacaeacaNacaeacbLaFbgbgagagag
acacalbEaRalbEacajajajacajajajacbLaFhmbgagagag
acazalbEbpalbzacacabacacacabacacbLbLbGbGbGacac
bGazalbEbpalbPacanalbEaAazalaBacaMaMaMaGaMaMac
bGazalbEbpalbEbGazalbEaOazalbEbGalalalalalaQat
ataPalbEbpalaIacazalarbGazalbEacaKbibibibibibG
acaualbEbpalbzatakalbEbGazalaoataTacbGbGacbGbG
bGazalarbpalaYacazalbPacazalbEacHWpSaMaMaMaMbG
bGazalbEbpalbEbGazalbEacazalbEbGalalalalalPtac
acaPalalalalalabalalalpqalalalabalbibihybibUac
acaDaabLbGbGbGacacacbTaVbbacacacacbGbGbGbGacac
acacaaaFbgbgagagagacbGbGbGacagagagagagagagagag
agacaaaFhmbgagagagagagagagagagagagagagagagagag
agagaaaaagagagagagagagagagagagagagagagagagagag
"}
