//MAP CONVERTED BY dmm2tgm.py THIS HEADER COMMENT PREVENTS RECONVERSION, DO NOT REMOVE
"ab" = (
/obj/machinery/door/airlock/shuttle/glass,
/turf/open/floor/mineral/plastitanium,
/area/shuttle/arrival)
"ac" = (
/turf/closed/wall/mineral/titanium,
/area/shuttle/arrival)
"ag" = (
/turf/template_noop,
/area/template_noop)
"ai" = (
/obj/effect/turf_decal/stripes{
	dir = 1
	},
/turf/open/floor/mineral/plastitanium,
/area/shuttle/arrival)
"aj" = (
/turf/open/floor/mineral/plastitanium,
/area/shuttle/arrival)
"am" = (
/obj/item/kirbyplants/random,
/obj/item/cardboard_cutout,
/turf/open/floor/mineral/titanium/yellow,
/area/shuttle/arrival)
"an" = (
/turf/closed/wall/mineral/plastitanium,
/area/shuttle/arrival)
"ar" = (
/obj/machinery/light/directional/east,
/turf/open/floor/mineral/titanium/yellow,
/area/shuttle/arrival)
"at" = (
/obj/structure/sign/nanotrasen,
/turf/closed/wall/mineral/titanium,
/area/shuttle/arrival)
"au" = (
/obj/structure/chair/comfy/shuttle{
	dir = 4
	},
/obj/machinery/status_display/evac{
	pixel_x = -32
	},
/turf/open/floor/mineral/titanium/yellow,
/area/shuttle/arrival)
"az" = (
/obj/structure/chair/comfy/shuttle{
	dir = 4
	},
/turf/open/floor/mineral/titanium/yellow,
/area/shuttle/arrival)
"aA" = (
/obj/structure/shuttle/engine/large{
	dir = 4
	},
/turf/template_noop,
/area/shuttle/arrival)
"aB" = (
/obj/machinery/light/directional/west,
/turf/open/floor/mineral/plastitanium,
/area/shuttle/arrival)
"aD" = (
/obj/item/megaphone,
/obj/item/kirbyplants/random,
/turf/open/floor/mineral/titanium/yellow,
/area/shuttle/arrival)
"aF" = (
/obj/structure/shuttle/engine/heater{
	dir = 4
	},
/turf/open/floor/plating,
/area/shuttle/arrival)
"aH" = (
/obj/docking_port/mobile/arrivals{
	dir = 2;
	port_direction = 4;
	preferred_direction = 8
	},
/obj/machinery/door/airlock/shuttle/glass,
/turf/open/floor/mineral/plastitanium,
/area/shuttle/arrival)
"aK" = (
/obj/machinery/light/directional/east,
/turf/open/floor/mineral/plastitanium,
/area/shuttle/arrival)
"aM" = (
/obj/machinery/newscaster{
	pixel_x = -32
	},
/turf/open/floor/mineral/titanium/yellow,
/area/shuttle/arrival)
"aN" = (
/obj/effect/turf_decal/arrows{
	dir = 1;
	icon_state = "arrows"
	},
/turf/open/floor/mineral/plastitanium,
/area/shuttle/arrival)
"aO" = (
/obj/machinery/requests_console{
	department = "Arrival shuttle";
	name = "Arrivals Shuttle console";
	pixel_y = 32
	},
/turf/closed/wall/mineral/titanium,
/area/shuttle/arrival)
"aP" = (
/obj/structure/chair/comfy/shuttle{
	dir = 4
	},
/obj/machinery/light{
	dir = 8
	},
/turf/open/floor/mineral/titanium/yellow,
/area/shuttle/arrival)
"aQ" = (
/obj/structure/chair/comfy/shuttle{
	dir = 1
	},
/turf/open/floor/mineral/titanium/yellow,
/area/shuttle/arrival)
"aR" = (
/obj/structure/chair/comfy/shuttle{
	dir = 4
	},
/obj/structure/window/reinforced{
	dir = 8
	},
/turf/open/floor/mineral/titanium/yellow,
/area/shuttle/arrival)
"aT" = (
/obj/structure/curtain,
/obj/structure/toilet{
	dir = 8
	},
/turf/open/floor/mineral/titanium/yellow,
/area/shuttle/arrival)
"aV" = (
/obj/machinery/vending/cola,
/obj/machinery/light/directional/east,
/turf/open/floor/mineral/titanium/yellow,
/area/shuttle/arrival)
"aY" = (
/turf/open/floor/mineral/titanium/blue,
/area/shuttle/arrival)
"bb" = (
/obj/structure/closet/emcloset/anchored,
/turf/open/floor/mineral/titanium/yellow,
/area/shuttle/arrival)
"bg" = (
/turf/template_noop,
/area/shuttle/arrival)
"bp" = (
/obj/structure/window/reinforced{
	dir = 8
	},
/obj/structure/chair/comfy/shuttle{
	dir = 4
	},
/turf/open/floor/mineral/titanium/yellow,
/area/shuttle/arrival)
"bz" = (
/obj/structure/chair/comfy/shuttle{
	dir = 8
	},
/obj/machinery/light{
	dir = 4
	},
/turf/open/floor/mineral/titanium/yellow,
/area/shuttle/arrival)
"bE" = (
/obj/structure/chair/comfy/shuttle{
	dir = 8
	},
/turf/open/floor/mineral/titanium/yellow,
/area/shuttle/arrival)
"bG" = (
/obj/effect/spawner/structure/window/reinforced/shuttle,
/turf/open/floor/plating,
/area/shuttle/arrival)
"bL" = (
/turf/closed/wall/mineral/plastitanium/nodiagonal,
/area/shuttle/arrival)
"bP" = (
/obj/structure/chair/comfy/shuttle{
	dir = 8
	},
/obj/item/radio/intercom{
	dir = 4;
	name = "Station Intercom (General)";
	pixel_x = 28
	},
/turf/open/floor/mineral/titanium/yellow,
/area/shuttle/arrival)
"bU" = (
/obj/machinery/status_display/evac{
	pixel_x = 32
	},
/turf/open/floor/mineral/titanium/yellow,
/area/shuttle/arrival)
"cv" = (
/obj/structure/chair/comfy/shuttle{
	dir = 4
	},
/obj/item/radio,
/turf/open/floor/mineral/titanium/yellow,
/area/shuttle/arrival)
"hm" = (
/obj/effect/spawner/random/clothing/wardrobe_closet_colored,
/turf/open/floor/mineral/titanium/blue,
/area/shuttle/arrival)
"hy" = (
/turf/open/floor/mineral/titanium/yellow,
/area/shuttle/arrival)
"mD" = (
/obj/machinery/status_display/evac/directional/west,
/turf/open/floor/mineral/titanium/yellow,
/area/shuttle/arrival)
"oG" = (
/obj/effect/spawner/random/clothing/wardrobe_closet_colored,
/obj/machinery/light/directional/south,
/turf/open/floor/mineral/titanium/blue,
/area/shuttle/arrival)
"pq" = (
/obj/machinery/vending/cigarette,
/turf/open/floor/mineral/titanium/yellow,
/area/shuttle/arrival)
"pK" = (
/obj/structure/closet/emcloset/anchored,
/obj/machinery/light/directional/west,
/turf/open/floor/mineral/titanium/yellow,
/area/shuttle/arrival)
"pL" = (
/obj/machinery/status_display/evac/directional/south,
/turf/open/floor/mineral/titanium/yellow,
/area/shuttle/arrival)
"pS" = (
/obj/structure/chair/comfy/shuttle,
/obj/item/bikehorn,
/turf/open/floor/mineral/titanium/yellow,
/area/shuttle/arrival)
"sF" = (
/obj/item/kirbyplants/random,
/turf/open/floor/mineral/titanium/yellow,
/area/shuttle/arrival)
"HW" = (
/obj/machinery/door/airlock/shuttle{
	name = "Arrival Shuttle Airlock"
	},
/turf/open/floor/mineral/plastitanium,
/area/shuttle/arrival)
"IO" = (
/obj/machinery/light{
	dir = 4
	},
/obj/structure/chair/comfy/shuttle{
	dir = 1
	},
/turf/open/floor/mineral/titanium/yellow,
/area/shuttle/arrival)
"Jk" = (
/obj/machinery/light{
	dir = 4
	},
/turf/open/floor/mineral/titanium/yellow,
/area/shuttle/arrival)
"JZ" = (
/obj/machinery/status_display/evac/directional/east,
/turf/open/floor/mineral/titanium/yellow,
/area/shuttle/arrival)
"KC" = (
/obj/structure/shuttle/engine/propulsion{
	dir = 4
	},
/turf/template_noop,
/area/shuttle/arrival)
"Lo" = (
/obj/structure/chair/comfy/shuttle{
	dir = 1
	},
/obj/item/radio,
/turf/open/floor/mineral/titanium/yellow,
/area/shuttle/arrival)
"Pt" = (
/obj/structure/chair/comfy/shuttle,
/turf/open/floor/mineral/titanium/yellow,
/area/shuttle/arrival)
"Qr" = (
/obj/effect/spawner/structure/window/reinforced/shuttle,
/turf/open/space/basic,
/area/shuttle/arrival)
"Vu" = (
/obj/structure/chair/comfy/shuttle,
/obj/item/radio/intercom{
	dir = 4;
	name = "Station Intercom (General)";
	pixel_y = 27
	},
/turf/open/floor/mineral/titanium/yellow,
/area/shuttle/arrival)

(1,1,1) = {"
ag
ag
ag
ac
ac
bG
bG
at
ac
bG
bG
ac
ac
ac
ag
ag
"}
(2,1,1) = {"
ag
ag
ac
ac
az
az
cv
aP
au
az
az
aP
aD
ac
ac
ag
"}
(3,1,1) = {"
ag
ac
ac
hy
hy
hy
hy
hy
hy
hy
hy
hy
hy
hy
ac
ac
"}
(4,1,1) = {"
ag
bG
am
bE
bE
bE
hy
hy
hy
aY
aY
aY
aY
aY
hm
bG
"}
(5,1,1) = {"
ag
bG
aR
aR
bp
bp
hy
hy
aY
aY
aY
aY
aY
aY
hm
bG
"}
(6,1,1) = {"
ag
bG
hy
hy
hy
hy
hy
hy
aY
aY
aY
aY
aY
aY
hm
bG
"}
(7,1,1) = {"
ag
ac
bE
bE
bz
bP
JZ
hy
aY
aY
aY
aY
aY
aY
oG
ac
"}
(8,1,1) = {"
ac
ac
ac
ac
ac
ac
ac
ac
aY
aY
aY
aY
aY
aY
hm
bG
"}
(9,1,1) = {"
ab
ai
aN
aB
aj
ac
hy
hy
aY
aY
aY
aY
aY
aY
hm
bG
"}
(10,1,1) = {"
at
ac
ac
aj
aj
HW
hy
hy
hy
aY
aY
aY
aY
aY
hm
bG
"}
(11,1,1) = {"
aH
ai
aN
aK
aj
ac
hy
ar
hy
hy
hy
hy
hy
sF
ac
ac
"}
(12,1,1) = {"
ac
ac
ac
bG
ac
ac
aO
at
ac
hy
hy
pq
aV
ac
ac
ag
"}
(13,1,1) = {"
ab
ai
aN
aB
aj
ac
hy
hy
hy
hy
hy
ac
ac
ac
ag
ag
"}
(14,1,1) = {"
at
ac
ac
aj
aj
HW
hy
hy
hy
hy
hy
mD
pK
bG
ag
ag
"}
(15,1,1) = {"
ab
ai
aN
aK
aj
ac
hy
hy
hy
hy
hy
hy
hy
bG
ag
ag
"}
(16,1,1) = {"
ac
ac
ac
ac
ac
ac
hy
ar
hy
hy
hy
hy
aQ
bG
ag
ag
"}
(17,1,1) = {"
bL
bL
bL
bL
bb
aM
hy
ac
aT
ac
hy
hy
aQ
ac
ag
ag
"}
(18,1,1) = {"
an
aF
aF
bL
hy
hy
pL
ac
ac
ac
Vu
hy
aQ
ac
ag
ag
"}
(19,1,1) = {"
ag
bg
aA
bG
Pt
hy
aQ
bG
KC
Qr
Pt
hy
aQ
bG
ag
ag
"}
(20,1,1) = {"
ag
bg
bg
bG
pS
hy
aQ
bG
ag
Qr
Pt
hy
Lo
bG
ag
ag
"}
(21,1,1) = {"
ag
ag
ag
bG
Pt
hy
aQ
ac
ag
ac
Pt
hy
aQ
bG
ag
ag
"}
(22,1,1) = {"
ag
ag
ag
ac
Pt
Jk
aQ
bG
ag
Qr
Pt
bU
IO
ac
ag
ag
"}
(23,1,1) = {"
ag
ag
ag
ac
ac
at
bG
bG
ag
Qr
bG
ac
ac
ac
ag
ag
"}
