"a" = (/turf/closed/wall/mineral/titanium,/area/shuttle/arrival)
"b" = (/turf/closed/wall/mineral/titanium/nodiagonal,/area/shuttle/arrival)
"c" = (/obj/effect/decal/cleanable/blood/footprints,/obj/machinery/light/floor,/turf/open/floor/mineral/titanium/white,/area/shuttle/arrival)
"d" = (/obj/effect/decal/cleanable/blood/footprints{dir = 8},/turf/open/floor/mineral/titanium,/area/shuttle/arrival)
"e" = (/obj/structure/closet/wardrobe/mixed,/turf/open/floor/mineral/titanium,/area/shuttle/arrival)
"f" = (/obj/structure/chair/comfy/shuttle{dir = 1},/turf/open/floor/mineral/titanium/white,/area/shuttle/arrival)
"h" = (/turf/open/floor/mineral/titanium,/area/shuttle/arrival)
"j" = (/obj/effect/turf_decal/weather/dirt{dir = 8},/obj/effect/turf_decal/weather/dirt{dir = 4},/obj/structure/window{dir = 4},/obj/structure/window{dir = 8},/obj/structure/flora/ausbushes/sparsegrass,/turf/open/floor/grass,/area/shuttle/arrival)
"k" = (/obj/effect/decal/cleanable/blood/footprints,/turf/open/floor/mineral/titanium/white,/area/shuttle/arrival)
"l" = (/obj/effect/turf_decal/weather/dirt{dir = 8},/obj/effect/turf_decal/weather/dirt{dir = 4},/obj/structure/window{dir = 4},/obj/structure/window{dir = 8},/obj/structure/flora/ausbushes/grassybush,/obj/structure/flora/ausbushes/ywflowers,/turf/open/floor/grass,/area/shuttle/arrival)
"m" = (/obj/structure/chair/comfy/shuttle{dir = 8},/turf/open/floor/mineral/titanium,/area/shuttle/arrival)
"n" = (/turf/template_noop,/area/space)
"o" = (/obj/effect/turf_decal/weather/dirt{dir = 8},/obj/effect/turf_decal/weather/dirt{dir = 4},/obj/structure/window{dir = 4},/obj/structure/window{dir = 8},/obj/structure/flora/ausbushes/sparsegrass,/obj/structure/flora/ausbushes/lavendergrass,/turf/open/floor/grass,/area/shuttle/arrival)
"p" = (/obj/structure/chair/comfy/shuttle{dir = 4},/turf/open/floor/mineral/titanium,/area/shuttle/arrival)
"q" = (/obj/structure/window/reinforced{dir = 1},/obj/structure/shuttle/engine/heater,/turf/open/floor/plating/airless,/area/shuttle/arrival)
"r" = (/obj/structure/chair/comfy/shuttle{dir = 8},/turf/open/floor/mineral/titanium/white,/area/shuttle/arrival)
"s" = (/obj/structure/chair/comfy/shuttle{dir = 4},/turf/open/floor/mineral/titanium/white,/area/shuttle/arrival)
"t" = (/turf/closed/wall/mineral/titanium/interior,/area/shuttle/arrival)
"u" = (/turf/open/floor/mineral/titanium/white,/area/shuttle/arrival)
"v" = (/obj/structure/extinguisher_cabinet{pixel_x = -30},/obj/structure/table,/obj/item/storage/toolbox/emergency,/turf/open/floor/mineral/titanium,/area/shuttle/arrival)
"w" = (/obj/effect/turf_decal/weather/dirt{dir = 8},/obj/effect/turf_decal/weather/dirt{dir = 4},/obj/structure/window{dir = 4},/obj/structure/window{dir = 8},/obj/structure/flora/ausbushes/grassybush,/obj/structure/flora/ausbushes/brflowers,/turf/open/floor/grass,/area/shuttle/arrival)
"x" = (/obj/structure/chair/comfy/shuttle{dir = 1},/obj/structure/sign/poster/official/enlist{pixel_y = -32},/turf/open/floor/mineral/titanium/white,/area/shuttle/arrival)
"y" = (/obj/structure/chair/comfy/shuttle,/turf/open/floor/mineral/titanium/white,/area/shuttle/arrival)
"z" = (/obj/effect/spawner/structure/window/shuttle,/turf/open/floor/plating/airless,/area/shuttle/arrival)
"A" = (/obj/structure/extinguisher_cabinet{pixel_x = -30},/turf/open/floor/mineral/titanium,/area/shuttle/arrival)
"C" = (/obj/effect/decal/cleanable/blood/footprints{dir = 4},/turf/open/floor/mineral/titanium,/area/shuttle/arrival)
"D" = (/obj/effect/turf_decal/weather/dirt{dir = 8},/obj/effect/turf_decal/weather/dirt{dir = 4},/obj/effect/turf_decal/weather/dirt{dir = 5},/obj/structure/window{dir = 1},/obj/structure/window{dir = 4},/obj/structure/window{dir = 8},/obj/structure/flora/ausbushes/leafybush,/turf/open/floor/grass,/area/shuttle/arrival)
"G" = (/obj/machinery/door/airlock/titanium{name = "Arrivals Shuttle"},/turf/open/floor/mineral/titanium,/area/shuttle/arrival)
"I" = (/obj/structure/shuttle/engine/propulsion,/turf/open/floor/plating/airless,/area/shuttle/arrival)
"J" = (/obj/structure/closet/emcloset,/turf/open/floor/mineral/titanium,/area/shuttle/arrival)
"K" = (/obj/effect/decal/cleanable/cobweb,/obj/structure/closet/emcloset,/turf/open/floor/mineral/titanium,/area/shuttle/arrival)
"L" = (/obj/structure/chair/comfy/shuttle,/obj/structure/sign/poster/official/enlist{pixel_y = 32},/turf/open/floor/mineral/titanium/white,/area/shuttle/arrival)
"N" = (/obj/structure/shuttle/engine/propulsion,/obj/docking_port/mobile/arrivals{dir = 1; dwidth = 5; height = 5; name = "Echo Arrivals"; width = 20},/turf/open/floor/plating/airless,/area/shuttle/arrival)
"P" = (/obj/structure/chair/comfy/shuttle,/turf/open/floor/mineral/titanium,/area/shuttle/arrival)
"Q" = (/obj/machinery/requests_console{department = "Arrival shuttle"; name = "Arrivals Shuttle console"; pixel_x = 32},/turf/open/floor/mineral/titanium,/area/shuttle/arrival)
"R" = (/obj/structure/shuttle/engine/heater,/obj/structure/window/reinforced{dir = 1},/turf/open/floor/plating/airless,/area/shuttle/arrival)
"S" = (/obj/effect/decal/cleanable/ash,/turf/open/floor/mineral/titanium/white,/area/shuttle/arrival)
"T" = (/obj/machinery/light/floor,/turf/open/floor/mineral/titanium/white,/area/shuttle/arrival)
"V" = (/obj/effect/decal/cleanable/blood/old,/obj/machinery/light/floor,/turf/open/floor/mineral/titanium/white,/area/shuttle/arrival)
"X" = (/obj/effect/decal/cleanable/blood/old,/turf/open/floor/mineral/titanium/white,/area/shuttle/arrival)
"Y" = (/obj/effect/turf_decal/weather/dirt{dir = 8},/obj/effect/turf_decal/weather/dirt{dir = 4},/obj/structure/window{dir = 4},/obj/structure/window{dir = 8},/obj/effect/turf_decal/weather/dirt{dir = 10},/obj/structure/window,/obj/structure/flora/ausbushes/leafybush,/turf/open/floor/grass,/area/shuttle/arrival)
"Z" = (/obj/machinery/light{dir = 4},/obj/structure/table,/obj/item/storage/firstaid/regular{pixel_y = 4},/turf/open/floor/mineral/titanium,/area/shuttle/arrival)

(1,1,1) = {"
nnazzzann
nazPPPzan
nbphhhmbn
nbhuTuhbn
abhttthba
bKhyLyhJb
bvuuuuSZb
zeVrDsTez
zhurlsuhz
zhurjsuhz
bhurosuhb
GhTrjsThG
bhkrwsuQb
zhkrYsuhz
zhkuuuuhz
zhcfxfThz
bAktttXhb
GdChhhhhG
bRRRqRRRb
aIIINIIIa
"}
