//MAP CONVERTED BY dmm2tgm.py THIS HEADER COMMENT PREVENTS RECONVERSION, DO NOT REMOVE
"aa" = (
/turf/closed/wall/mineral/plastitanium,
/area/shuttle/arrival)
"ab" = (
/obj/machinery/door/airlock/shuttle{
	name = "Arrival Shuttle Airlock"
	},
/turf/open/floor/mineral/plastitanium,
/area/shuttle/arrival)
"ac" = (
/turf/closed/wall/mineral/titanium,
/area/shuttle/arrival)
"ad" = (
/obj/structure/closet/emcloset/anchored,
/turf/open/floor/mineral/titanium/white,
/area/shuttle/arrival)
"ae" = (
/obj/effect/turf_decal/arrows{
	dir = 1;
	icon_state = "arrows"
	},
/obj/machinery/light{
	dir = 4
	},
/turf/open/floor/mineral/plastitanium,
/area/shuttle/arrival)
"ag" = (
/turf/template_noop,
/area/template_noop)
"ai" = (
/obj/effect/turf_decal/stripes{
	dir = 1
	},
/turf/open/floor/mineral/plastitanium,
/area/shuttle/arrival)
"aj" = (
/turf/open/floor/mineral/plastitanium,
/area/shuttle/arrival)
"ak" = (
/obj/machinery/light{
	dir = 8
	},
/obj/structure/chair/comfy/shuttle{
	dir = 4
	},
/turf/open/floor/mineral/titanium/white,
/area/shuttle/arrival)
"al" = (
/turf/open/floor/mineral/titanium/white,
/area/shuttle/arrival)
"am" = (
/obj/item/kirbyplants/random,
/obj/item/cardboard_cutout,
/turf/open/floor/mineral/titanium/white,
/area/shuttle/arrival)
"an" = (
/obj/machinery/light{
	dir = 1
	},
/obj/structure/chair/comfy/shuttle{
	dir = 4
	},
/turf/open/floor/mineral/titanium/white,
/area/shuttle/arrival)
"ao" = (
/obj/machinery/light{
	dir = 4
	},
/obj/structure/chair/comfy/shuttle{
	dir = 8
	},
/turf/open/floor/mineral/titanium/white,
/area/shuttle/arrival)
"ar" = (
/obj/structure/chair/comfy/shuttle{
	dir = 8
	},
/obj/item/radio,
/turf/open/floor/mineral/titanium/white,
/area/shuttle/arrival)
"at" = (
/obj/structure/sign/nanotrasen,
/turf/closed/wall/mineral/titanium,
/area/shuttle/arrival)
"au" = (
/obj/structure/chair/comfy/shuttle{
	dir = 4
	},
/obj/machinery/status_display/evac{
	pixel_x = -32
	},
/turf/open/floor/mineral/titanium/white,
/area/shuttle/arrival)
"az" = (
/obj/structure/chair/comfy/shuttle{
	dir = 4
	},
/turf/open/floor/mineral/titanium/white,
/area/shuttle/arrival)
"aA" = (
/obj/machinery/requests_console{
	department = "Arrival shuttle";
	name = "Arrivals Shuttle console"
	},
/turf/closed/wall/mineral/titanium,
/area/shuttle/arrival)
"aB" = (
/obj/machinery/light{
	dir = 1
	},
/obj/structure/chair/comfy/shuttle{
	dir = 8
	},
/turf/open/floor/mineral/titanium/white,
/area/shuttle/arrival)
"aD" = (
/obj/item/megaphone,
/obj/item/kirbyplants/random,
/turf/open/floor/mineral/titanium/white,
/area/shuttle/arrival)
"aF" = (
/obj/structure/shuttle/engine/heater{
	dir = 4
	},
/turf/open/floor/plating,
/area/shuttle/arrival)
"aG" = (
/obj/structure/chair/comfy/shuttle,
/obj/item/bikehorn,
/turf/open/floor/mineral/titanium/white,
/area/shuttle/arrival)
"aH" = (
/obj/machinery/door/airlock/shuttle{
	name = "Arrival Shuttle Airlock"
	},
/obj/docking_port/mobile/arrivals{
	dir = 2;
	port_direction = 4;
	preferred_direction = 8
	},
/turf/open/floor/mineral/plastitanium,
/area/shuttle/arrival)
"aI" = (
/obj/structure/chair/comfy/shuttle{
	dir = 8
	},
/obj/machinery/newscaster{
	pixel_x = 32
	},
/turf/open/floor/mineral/titanium/white,
/area/shuttle/arrival)
"aK" = (
/obj/machinery/newscaster{
	pixel_x = -32
	},
/turf/open/floor/mineral/titanium/white,
/area/shuttle/arrival)
"aM" = (
/obj/structure/chair/comfy/shuttle,
/turf/open/floor/mineral/titanium/white,
/area/shuttle/arrival)
"aN" = (
/obj/effect/turf_decal/arrows{
	dir = 1;
	icon_state = "arrows"
	},
/obj/machinery/light{
	dir = 8
	},
/turf/open/floor/mineral/plastitanium,
/area/shuttle/arrival)
"aO" = (
/obj/machinery/status_display/evac,
/turf/closed/wall/mineral/titanium,
/area/shuttle/arrival)
"aP" = (
/obj/structure/chair/comfy/shuttle{
	dir = 4
	},
/obj/machinery/light{
	dir = 8
	},
/turf/open/floor/mineral/titanium/white,
/area/shuttle/arrival)
"aQ" = (
/obj/machinery/light{
	dir = 4
	},
/obj/structure/closet/emcloset/anchored,
/turf/open/floor/mineral/titanium/white,
/area/shuttle/arrival)
"aR" = (
/obj/structure/chair/comfy/shuttle{
	dir = 4
	},
/obj/structure/window/reinforced{
	dir = 8
	},
/turf/open/floor/mineral/titanium/white,
/area/shuttle/arrival)
"aT" = (
/obj/machinery/light{
	dir = 8
	},
/turf/open/floor/mineral/titanium/white,
/area/shuttle/arrival)
"aV" = (
/obj/structure/toilet{
	dir = 1
	},
/obj/structure/curtain,
/obj/structure/window/reinforced{
	dir = 4
	},
/obj/structure/window/reinforced{
	dir = 8
	},
/turf/open/floor/mineral/titanium/white,
/area/shuttle/arrival)
"aY" = (
/obj/structure/chair/comfy/shuttle{
	dir = 8
	},
/obj/machinery/status_display/evac{
	pixel_x = 32
	},
/turf/open/floor/mineral/titanium/white,
/area/shuttle/arrival)
"bb" = (
/obj/machinery/vending/cola,
/turf/open/floor/mineral/titanium/white,
/area/shuttle/arrival)
"bg" = (
/turf/template_noop,
/area/shuttle/arrival)
"bi" = (
/obj/structure/chair/comfy/shuttle{
	dir = 1
	},
/turf/open/floor/mineral/titanium/white,
/area/shuttle/arrival)
"bp" = (
/obj/structure/window/reinforced{
	dir = 8
	},
/obj/structure/chair/comfy/shuttle{
	dir = 4
	},
/turf/open/floor/mineral/titanium/white,
/area/shuttle/arrival)
"bz" = (
/obj/structure/chair/comfy/shuttle{
	dir = 8
	},
/obj/machinery/light{
	dir = 4
	},
/turf/open/floor/mineral/titanium/white,
/area/shuttle/arrival)
"bE" = (
/obj/structure/chair/comfy/shuttle{
	dir = 8
	},
/turf/open/floor/mineral/titanium/white,
/area/shuttle/arrival)
"bG" = (
/obj/effect/spawner/structure/window/reinforced/shuttle,
/turf/open/floor/plating,
/area/shuttle/arrival)
"bL" = (
/turf/closed/wall/mineral/plastitanium/nodiagonal,
/area/shuttle/arrival)
"bP" = (
/obj/structure/chair/comfy/shuttle{
	dir = 8
	},
/obj/item/radio/intercom{
	dir = 4;
	name = "Station Intercom (General)";
	pixel_x = 28
	},
/turf/open/floor/mineral/titanium/white,
/area/shuttle/arrival)
"bT" = (
/obj/machinery/vending/cigarette,
/turf/open/floor/mineral/titanium/white,
/area/shuttle/arrival)
"bU" = (
/obj/machinery/light{
	dir = 4
	},
/obj/structure/chair/comfy/shuttle{
	dir = 1
	},
/turf/open/floor/mineral/titanium/white,
/area/shuttle/arrival)
"hm" = (
/obj/structure/shuttle/engine/large{
	dir = 4
	},
/turf/template_noop,
/area/shuttle/arrival)
"hy" = (
/obj/structure/chair/comfy/shuttle{
	dir = 1
	},
/obj/item/radio,
/turf/open/floor/mineral/titanium/white,
/area/shuttle/arrival)
"pq" = (
/obj/machinery/newscaster{
	pixel_y = 32
	},
/obj/machinery/light{
	dir = 1
	},
/turf/open/floor/mineral/titanium/white,
/area/shuttle/arrival)
"pS" = (
/obj/structure/chair/comfy/shuttle,
/obj/item/radio/intercom{
	dir = 4;
	name = "Station Intercom (General)";
	pixel_y = 27
	},
/turf/open/floor/mineral/titanium/white,
/area/shuttle/arrival)
"HW" = (
/obj/machinery/status_display/evac{
	pixel_x = -32
	},
/turf/open/floor/mineral/titanium/white,
/area/shuttle/arrival)
"Pt" = (
/obj/machinery/status_display/evac{
	pixel_x = 32
	},
/turf/open/floor/mineral/titanium/white,
/area/shuttle/arrival)

(1,1,1) = {"
ag
ag
ag
ac
ac
bG
bG
at
ac
bG
bG
ac
ac
ac
ag
ag
"}
(2,1,1) = {"
ag
ag
ac
ac
az
az
az
aP
au
az
az
aP
aD
ac
ac
ag
"}
(3,1,1) = {"
ag
ac
ac
al
al
al
al
al
al
al
al
al
aa
aa
aa
aa
"}
(4,1,1) = {"
ag
bG
am
bE
bE
bE
bE
bE
bE
ar
bE
al
bL
aF
aF
aa
"}
(5,1,1) = {"
ag
bG
aR
aR
bp
bp
bp
bp
bp
bp
bp
al
bG
bg
hm
ag
"}
(6,1,1) = {"
ag
bG
ad
al
al
al
al
al
al
al
al
al
bG
bg
bg
ag
"}
(7,1,1) = {"
ag
ac
bE
bE
bz
bP
bE
aI
bz
aY
bE
al
bG
ag
ag
ag
"}
(8,1,1) = {"
ac
ac
ac
ac
ac
ac
bG
ac
at
ac
bG
ab
ac
ag
ag
ag
"}
(9,1,1) = {"
ab
ai
aN
aj
ac
an
az
az
ak
az
az
al
ac
ag
ag
ag
"}
(10,1,1) = {"
at
ac
ac
aj
ab
al
al
al
al
al
al
al
ac
ac
ag
ag
"}
(11,1,1) = {"
aH
ai
ae
aj
ac
bE
bE
ar
bE
bP
bE
al
bT
bG
ag
ag
"}
(12,1,1) = {"
ac
ac
ac
ac
ac
aA
aO
bG
bG
ac
ac
pq
aV
bG
ag
ag
"}
(13,1,1) = {"
ab
ai
aN
aj
ac
az
az
az
az
az
az
al
bb
bG
ag
ag
"}
(14,1,1) = {"
at
ac
ac
aj
ab
al
al
al
al
al
al
al
ac
ac
ag
ag
"}
(15,1,1) = {"
ab
ai
ae
aj
ac
aB
bE
bE
ao
bE
bE
al
ac
ag
ag
ag
"}
(16,1,1) = {"
ac
ac
ac
ac
ac
ac
bG
ac
at
ac
bG
ab
ac
ag
ag
ag
"}
(17,1,1) = {"
ag
bL
bL
bL
bL
aM
al
aK
aT
HW
al
al
ac
ag
ag
ag
"}
(18,1,1) = {"
ag
aa
aF
aF
bL
aM
al
bi
ac
pS
al
bi
bG
ag
ag
ag
"}
(19,1,1) = {"
ag
ag
bg
hm
bG
aM
al
bi
bG
aM
al
bi
bG
ag
ag
ag
"}
(20,1,1) = {"
ag
ag
bg
bg
bG
aG
al
bi
bG
aM
al
hy
bG
ag
ag
ag
"}
(21,1,1) = {"
ag
ag
ag
ag
bG
aM
al
bi
ac
aM
al
bi
bG
ag
ag
ag
"}
(22,1,1) = {"
ag
ag
ag
ag
ac
aM
aQ
bi
bG
aM
Pt
bU
ac
ag
ag
ag
"}
(23,1,1) = {"
ag
ag
ag
ag
ac
ac
at
bG
bG
bG
ac
ac
ac
ag
ag
ag
"}
