"ay" = (/obj/structure/chair/comfy/shuttle{dir = 8},/obj/effect/turf_decal/stripes/corner,/obj/structure/sign/poster/official/random{pixel_x = 32},/turf/open/floor/mineral/titanium/white,/area/shuttle/arrival)
"aG" = (/obj/structure/chair/comfy/shuttle{dir = 4},/obj/effect/turf_decal/stripes/corner{dir = 8},/obj/structure/sign/poster/official/random{pixel_x = -32},/obj/machinery/light/directional/west,/turf/open/floor/mineral/titanium/white,/area/shuttle/arrival)
"cr" = (/obj/structure/chair/comfy/shuttle{dir = 8},/obj/effect/decal/cleanable/blood/splatter,/turf/open/floor/mineral/titanium/white,/area/shuttle/arrival)
"dl" = (/turf/open/floor/mineral/titanium/white,/area/shuttle/arrival)
"dz" = (/obj/machinery/light/directional/south,/obj/effect/turf_decal/stripes/corner{dir = 8},/turf/open/floor/mineral/titanium,/area/shuttle/arrival)
"fE" = (/obj/structure/chair/comfy/shuttle{dir = 4},/obj/structure/sign/poster/official/random{pixel_y = -32},/turf/open/floor/mineral/titanium/white,/area/shuttle/arrival)
"gy" = (/obj/machinery/light/directional/east,/obj/structure/chair/comfy/shuttle{dir = 8},/turf/open/floor/mineral/titanium/white,/area/shuttle/arrival)
"hi" = (/obj/effect/decal/cleanable/blood/tracks,/obj/effect/turf_decal/stripes/line{dir = 1},/turf/open/floor/mineral/titanium/blue,/area/shuttle/arrival)
"ii" = (/obj/effect/decal/cleanable/blood/tracks{dir = 10},/turf/open/floor/mineral/titanium,/area/shuttle/arrival)
"ju" = (/obj/effect/decal/cleanable/blood/bubblegum,/turf/open/floor/mineral/titanium/blue,/area/shuttle/arrival)
"kt" = (/obj/effect/decal/cleanable/blood/tracks{dir = 4},/turf/open/floor/mineral/titanium,/area/shuttle/arrival)
"kz" = (/obj/structure/chair/comfy/shuttle,/obj/machinery/light/directional/north,/obj/effect/turf_decal/stripes/corner{dir = 1},/turf/open/floor/mineral/titanium/blue,/area/shuttle/arrival)
"kU" = (/obj/machinery/light/directional/west,/obj/structure/chair/comfy/shuttle{dir = 4},/turf/open/floor/mineral/titanium/white,/area/shuttle/arrival)
"lI" = (/obj/machinery/status_display/evac,/turf/closed/wall/mineral/titanium,/area/shuttle/arrival)
"nW" = (/obj/structure/chair/comfy/shuttle,/obj/effect/turf_decal/stripes/corner{dir = 8},/turf/open/floor/mineral/titanium/white,/area/shuttle/arrival)
"oV" = (/turf/closed/wall/mineral/plastitanium,/area/shuttle/arrival)
"qp" = (/obj/machinery/door/airlock/shuttle{name = "Arrival Shuttle Airlock"},/turf/open/floor/mineral/titanium,/area/shuttle/arrival)
"rf" = (/obj/machinery/door/airlock/shuttle{name = "Arrival Shuttle Airlock"},/obj/effect/decal/cleanable/blood/tracks,/turf/open/floor/mineral/titanium,/area/shuttle/arrival)
"sL" = (/obj/effect/spawner/structure/window/shuttle,/turf/open/floor/plating{initial_gas_mix = "o2=0.01;n2=0.01;TEMP=2.7"; luminosity = 2; temperature = 2.7},/area/shuttle/arrival)
"up" = (/obj/item/kirbyplants{icon_state = "plant-21"},/obj/effect/turf_decal/stripes/corner{dir = 4},/obj/machinery/light/directional/east,/turf/open/floor/mineral/titanium,/area/shuttle/arrival)
"uM" = (/obj/structure/window{dir = 8},/obj/structure/window,/obj/structure/window{dir = 4},/turf/open/floor/grass,/area/shuttle/arrival)
"vr" = (/obj/effect/turf_decal/stripes/line{dir = 8},/turf/open/floor/mineral/titanium/white,/area/shuttle/arrival)
"vC" = (/obj/structure/chair/comfy/shuttle,/turf/open/floor/mineral/titanium/white,/area/shuttle/arrival)
"vT" = (/obj/structure/extinguisher_cabinet{pixel_x = -26},/obj/effect/turf_decal/stripes/corner{dir = 1},/turf/open/floor/mineral/titanium/white,/area/shuttle/arrival)
"xf" = (/obj/effect/decal/cleanable/blood/splatter,/turf/open/floor/mineral/titanium/blue,/area/shuttle/arrival)
"Aa" = (/obj/effect/turf_decal/stripes/line{dir = 8},/turf/open/floor/mineral/titanium,/area/shuttle/arrival)
"Am" = (/turf/open/floor/plating{initial_gas_mix = "o2=0.01;n2=0.01;TEMP=2.7"; luminosity = 2; temperature = 2.7},/area/shuttle/arrival)
"AD" = (/obj/structure/chair/comfy/shuttle,/obj/effect/turf_decal/stripes/corner,/turf/open/floor/mineral/titanium/white,/area/shuttle/arrival)
"AV" = (/turf/template_noop,/area/shuttle/arrival)
"Ca" = (/turf/open/floor/mineral/titanium/blue,/area/shuttle/arrival)
"CD" = (/obj/structure/shuttle/engine/propulsion{dir = 1},/obj/effect/turf_decal/stripes/line{dir = 1},/turf/open/floor/plating/airless,/area/shuttle/arrival)
"CT" = (/obj/item/kirbyplants{icon_state = "plant-21"},/obj/effect/turf_decal/stripes/corner{dir = 1},/turf/open/floor/mineral/titanium,/area/shuttle/arrival)
"FF" = (/obj/effect/turf_decal/stripes/line{dir = 4},/turf/open/floor/plating{initial_gas_mix = "o2=0.01;n2=0.01;TEMP=2.7"; luminosity = 2; temperature = 2.7},/area/shuttle/arrival)
"FZ" = (/obj/structure/chair/comfy/shuttle{dir = 8},/turf/open/floor/mineral/titanium/white,/area/shuttle/arrival)
"Gh" = (/obj/structure/chair/comfy/shuttle,/obj/machinery/light/directional/north,/obj/effect/turf_decal/stripes/corner{dir = 4},/turf/open/floor/mineral/titanium/blue,/area/shuttle/arrival)
"Hc" = (/obj/structure/chair/comfy/shuttle{dir = 4},/turf/open/floor/mineral/titanium/white,/area/shuttle/arrival)
"IV" = (/obj/structure/window/reinforced,/obj/structure/shuttle/engine/heater{dir = 1},/obj/effect/turf_decal/stripes/line{dir = 1},/turf/open/floor/plating/airless,/area/shuttle/arrival)
"JT" = (/obj/structure/chair/comfy/shuttle{dir = 8},/obj/structure/sign/poster/official/random{pixel_y = -32},/turf/open/floor/mineral/titanium/white,/area/shuttle/arrival)
"JX" = (/obj/effect/turf_decal/stripes/line{dir = 4},/turf/open/floor/mineral/titanium/white,/area/shuttle/arrival)
"Mx" = (/turf/open/floor/plating{icon_state = "platingdmg2"},/area/shuttle/arrival)
"Nk" = (/obj/structure/chair/comfy/shuttle{dir = 4},/obj/effect/decal/cleanable/blood/splatter,/turf/open/floor/mineral/titanium/white,/area/shuttle/arrival)
"Ns" = (/obj/machinery/door/airlock/shuttle{name = "Arrival Shuttle Airlock"},/turf/open/floor/mineral/titanium/white,/area/shuttle/arrival)
"QT" = (/obj/effect/turf_decal/stripes/corner{dir = 4},/turf/open/floor/mineral/titanium/white,/area/shuttle/arrival)
"Ro" = (/turf/closed/wall/mineral/titanium/nodiagonal,/area/shuttle/arrival)
"RS" = (/obj/structure/window{dir = 8},/obj/structure/window{dir = 4},/turf/open/floor/grass,/area/shuttle/arrival)
"Tt" = (/obj/machinery/light/directional/south,/obj/effect/turf_decal/stripes/corner,/turf/open/floor/mineral/titanium,/area/shuttle/arrival)
"Uo" = (/turf/open/floor/mineral/titanium,/area/shuttle/arrival)
"Vh" = (/turf/closed/wall/mineral/titanium,/area/shuttle/arrival)
"VL" = (/obj/effect/decal/cleanable/blood/tracks{dir = 5},/turf/open/floor/mineral/titanium,/area/shuttle/arrival)
"VQ" = (/obj/structure/window{dir = 8},/obj/structure/window{dir = 4},/obj/structure/window{dir = 1},/turf/open/floor/grass,/area/shuttle/arrival)
"Wy" = (/obj/effect/decal/cleanable/blood/tracks,/obj/effect/turf_decal/stripes/line,/turf/open/floor/mineral/titanium,/area/shuttle/arrival)
"Ya" = (/obj/docking_port/mobile/arrivals{dir = 2; dwidth = 4; height = 17; name = "delta arrivals shuttle"; width = 9},/turf/closed/wall/mineral/plastitanium,/area/shuttle/arrival)
"Yr" = (/obj/effect/spawner/structure/window/shuttle,/turf/open/floor/plating,/area/shuttle/arrival)

(1,1,1) = {"
AVCDCDCDYaCDCDCDAV
oVoVIVIVoVIVIVoVoV
RoVhYrYrRoYrYrVhRo
VhkUUoUoUoUoMxgyVh
YrHcAmFZVQHcUoFZYr
YrHcUoFZRSHcUoFZYr
YrHcUocrRSHcUoFZYr
VhaGUoFZRSHcUoayVh
qpAaUoFZRSHcUoFFqp
VhCTUoFZuMNkUoupVh
YrHciiktVLUoUoFZYr
VhfEAmTtWydzUoJTVh
VhVhYrlIrflIYrVhVh
VhnWvCGhhikzvCADVh
NsvrdlCajuxfdlJXNs
VhvTdlCaCaCadlQTVh
RosLsLsLsLsLsLsLRo
"}
