"a" = (/obj/effect/turf_decal/tile/brown{dir = 8},/obj/effect/turf_decal/tile/brown{dir = 4},/obj/effect/turf_decal/tile/brown,/obj/effect/turf_decal/tile/brown{dir = 1},/turf/open/floor/mineral/titanium/white,/area/shuttle/supply)
"b" = (/obj/machinery/door/poddoor{id = "QMLoaddoor"; name = "supply dock loading door"},/obj/machinery/conveyor{dir = 8; id = "Cargo Belt"},/turf/open/floor/plating,/area/shuttle/supply)
"c" = (/obj/machinery/door/poddoor{id = "QMLoaddoor2"; name = "supply dock loading door"},/obj/machinery/conveyor{dir = 4; id = "cargodelivery2"; name = "Cargo Belt"},/turf/open/floor/plating,/area/shuttle/supply)
"d" = (/obj/structure/window/reinforced{dir = 1},/obj/structure/shuttle/engine/heater,/turf/open/floor/plating/airless,/area/shuttle/supply)
"e" = (/obj/machinery/light{dir = 4},/obj/machinery/button/door{id = "QMLoaddoor2"; name = "Loading Doors South"; pixel_x = 24; pixel_y = -8},/obj/machinery/button/door{id = "QMLoaddoor"; layer = 4; name = "Loading Doors North"; pixel_x = 24; pixel_y = 8; req_access_txt = "31"},/turf/open/floor/mineral/titanium/blue,/area/shuttle/supply)
"y" = (/obj/machinery/door/airlock/titanium{name = "Supply Shuttle Airlock"; req_access_txt = "31"},/turf/open/floor/plating,/area/shuttle/supply)
"A" = (/obj/machinery/light{dir = 8},/turf/open/floor/mineral/titanium/blue,/area/shuttle/supply)
"G" = (/obj/machinery/door/airlock/titanium{name = "Supply Shuttle Airlock"; req_access_txt = "31"},/obj/docking_port/mobile/supply{anchored = 5; dwidth = 4; height = 6; width = 10},/turf/open/floor/plating,/area/shuttle/supply)
"I" = (/obj/structure/shuttle/engine/heater,/obj/structure/window/reinforced{dir = 1},/turf/open/floor/plating/airless,/area/shuttle/supply)
"K" = (/obj/structure/shuttle/engine/propulsion,/turf/open/floor/plating/airless,/area/shuttle/supply)
"M" = (/turf/closed/wall/mineral/titanium,/area/shuttle/supply)
"O" = (/turf/template_noop,/area/template_noop)
"T" = (/turf/open/floor/mineral/titanium/blue,/area/shuttle/supply)
"W" = (/obj/effect/turf_decal/tile/brown{dir = 4},/obj/effect/turf_decal/tile/brown,/obj/effect/turf_decal/tile/brown{dir = 1},/obj/effect/turf_decal/tile/brown{dir = 8},/turf/open/floor/mineral/titanium/white,/area/shuttle/supply)

(1,1,1) = {"
MMMMMMM
MaWWWWM
MaWWWWb
MaTTTWy
MATTTeM
MaTTTWG
MaWWWWc
MaWWWWM
MMdIIMM
OKKKKKO
"}
