//MAP CONVERTED BY dmm2tgm.py THIS HEADER COMMENT PREVENTS RECONVERSION, DO NOT REMOVE
"a" = (
/obj/effect/spawner/structure/window/shuttle,
/turf/open/floor/plating/airless,
/area/shuttle/supply)
"c" = (
/obj/structure/closet/crate/secure/loot,
/turf/open/floor/mineral/titanium/yellow,
/area/shuttle/supply)
"f" = (
/obj/effect/decal/cleanable/glass,
/turf/open/floor/mineral/titanium/airless,
/area/shuttle/supply)
"h" = (
/obj/structure/shuttle/engine/heater,
/obj/structure/window/reinforced{
	dir = 1;
	layer = 2.9
	},
/turf/open/floor/plating/airless,
/area/shuttle/supply)
"i" = (
/turf/closed/wall/mineral/titanium,
/area/shuttle/supply)
"j" = (
/obj/effect/decal/cleanable/wrapping,
/turf/open/floor/mineral/titanium/airless,
/area/shuttle/supply)
"k" = (
/turf/open/floor/mineral/titanium/white,
/area/shuttle/supply)
"l" = (
/obj/item/trash/popcorn,
/turf/open/floor/mineral/titanium/airless,
/area/shuttle/supply)
"m" = (
/obj/structure/closet/crate/internals,
/turf/open/floor/mineral/titanium/yellow,
/area/shuttle/supply)
"n" = (
/obj/structure/window/reinforced,
/obj/structure/window/reinforced{
	dir = 4
	},
/obj/structure/closet/crate/secure/loot,
/turf/open/floor/mineral/titanium/yellow,
/area/shuttle/supply)
"o" = (
/obj/effect/decal/cleanable/xenoblood/xgibs,
/turf/open/floor/mineral/titanium/airless,
/area/shuttle/supply)
"p" = (
/turf/open/floor/mineral/titanium/airless,
/area/shuttle/supply)
"q" = (
/obj/structure/closet/crate,
/turf/open/floor/mineral/titanium/yellow,
/area/shuttle/supply)
"r" = (
/obj/effect/decal/cleanable/blood/tracks{
	dir = 4
	},
/turf/open/floor/mineral/titanium/airless,
/area/shuttle/supply)
"s" = (
/obj/item/trash/can/food/beans,
/turf/open/floor/mineral/titanium/airless,
/area/shuttle/supply)
"t" = (
/obj/structure/window/reinforced{
	dir = 1;
	layer = 2.9
	},
/obj/structure/shuttle/engine/heater,
/turf/open/floor/plating/airless,
/area/shuttle/supply)
"v" = (
/turf/open/floor/mineral/titanium/yellow,
/area/shuttle/supply)
"w" = (
/obj/structure/closet/crate,
/turf/open/floor/mineral/titanium/white,
/area/shuttle/supply)
"x" = (
/obj/item/trash/candy,
/obj/structure/closet/crate/trashcart,
/turf/open/floor/mineral/titanium/airless,
/area/shuttle/supply)
"y" = (
/obj/structure/window/reinforced{
	dir = 8
	},
/obj/structure/window/reinforced,
/turf/open/floor/mineral/titanium/yellow,
/area/shuttle/supply)
"z" = (
/obj/effect/decal/cleanable/cobweb,
/turf/closed/wall/mineral/titanium/nodiagonal,
/area/shuttle/supply)
"A" = (
/obj/effect/decal/cleanable/blood,
/obj/effect/decal/cleanable/vomit,
/turf/open/floor/mineral/titanium/airless,
/area/shuttle/supply)
"C" = (
/obj/structure/closet/crate/freezer,
/obj/item/trash/popcorn,
/turf/open/floor/mineral/titanium/yellow,
/area/shuttle/supply)
"D" = (
/obj/effect/decal/cleanable/wrapping,
/obj/structure/closet,
/turf/open/floor/mineral/titanium/airless,
/area/shuttle/supply)
"E" = (
/obj/structure/closet,
/obj/effect/decal/cleanable/cobweb,
/turf/open/floor/mineral/titanium/yellow,
/area/shuttle/supply)
"F" = (
/turf/template_noop,
/area/space)
"G" = (
/obj/machinery/light{
	dir = 8
	},
/obj/machinery/button/door{
	id = "QMLoaddoor";
	layer = 4;
	name = "Loading Doors North";
	pixel_x = -23;
	pixel_y = 8;
	req_access_txt = "31"
	},
/turf/open/floor/mineral/titanium/yellow,
/area/shuttle/supply)
"H" = (
/obj/effect/decal/cleanable/crayon,
/turf/open/floor/mineral/titanium/white,
/area/shuttle/supply)
"K" = (
/turf/closed/wall/mineral/titanium/nodiagonal,
/area/shuttle/supply)
"M" = (
/obj/effect/decal/cleanable/plastic,
/turf/open/floor/mineral/titanium/white,
/area/shuttle/supply)
"N" = (
/obj/effect/decal/cleanable/blood/old,
/turf/open/floor/mineral/titanium/airless,
/area/shuttle/supply)
"Q" = (
/obj/machinery/door/airlock/titanium{
	name = "Supply Shuttle Airlock";
	req_access_txt = "31"
	},
/turf/open/floor/mineral/titanium/airless,
/area/shuttle/supply)
"R" = (
/obj/effect/decal/cleanable/wrapping,
/turf/open/floor/mineral/titanium/white,
/area/shuttle/supply)
"T" = (
/obj/structure/shuttle/engine/propulsion/burst/cargo,
/turf/open/floor/plating/airless,
/area/shuttle/supply)
"V" = (
/obj/machinery/door/airlock/titanium{
	name = "Supply Shuttle Airlock";
	req_access_txt = "31"
	},
/obj/docking_port/mobile/supply{
	dir = 4;
	dwidth = 8;
	height = 5;
	width = 6
	},
/turf/open/floor/mineral/titanium/airless,
/area/shuttle/supply)
"W" = (
/obj/effect/decal/cleanable/chem_pile,
/turf/open/floor/mineral/titanium/white,
/area/shuttle/supply)
"X" = (
/obj/machinery/light{
	dir = 8
	},
/obj/machinery/button/door{
	id = "QMLoaddoor2";
	name = "Loading Doors South";
	pixel_x = -23;
	pixel_y = -8
	},
/turf/open/floor/mineral/titanium/yellow,
/area/shuttle/supply)
"Z" = (
/obj/machinery/door/poddoor{
	id = "QMLoaddoor";
	name = "supply dock loading door"
	},
/turf/open/floor/mineral/titanium/airless,
/area/shuttle/supply)

(1,1,1) = {"
F
i
Z
K
V
a
a
Q
K
Z
i
K
"}
(2,1,1) = {"
i
z
r
G
p
w
R
p
X
p
n
T
"}
(3,1,1) = {"
K
E
A
C
p
k
k
l
v
f
h
T
"}
(4,1,1) = {"
K
c
j
v
s
H
k
N
v
p
t
T
"}
(5,1,1) = {"
i
K
p
q
o
M
W
x
m
D
y
T
"}
(6,1,1) = {"
F
i
K
a
K
a
a
K
a
K
i
K
"}
