//MAP CONVERTED BY dmm2tgm.py THIS HEADER COMMENT PREVENTS RECONVERSION, DO NOT REMOVE
"a" = (
/obj/effect/turf_decal/stripes/line{
	dir = 4
	},
/turf/open/floor/iron,
/area/shuttle/supply)
"b" = (
/turf/template_noop,
/area/shuttle/supply)
"c" = (
/obj/effect/decal/cleanable/dirt,
/obj/effect/turf_decal/stripes/line{
	dir = 1
	},
/obj/machinery/light/small/directional/north,
/turf/open/floor/iron,
/area/shuttle/supply)
"d" = (
/turf/open/floor/iron,
/area/shuttle/supply)
"e" = (
/obj/effect/turf_decal/stripes/line{
	dir = 8
	},
/turf/open/floor/iron,
/area/shuttle/supply)
"f" = (
/obj/effect/decal/cleanable/dirt,
/obj/effect/turf_decal/delivery,
/turf/open/floor/iron,
/area/shuttle/supply)
"g" = (
/obj/effect/turf_decal/stripes/line{
	dir = 6
	},
/turf/open/floor/iron,
/area/shuttle/supply)
"h" = (
/obj/structure/window/reinforced{
	dir = 1
	},
/obj/structure/shuttle/engine/heater,
/obj/effect/turf_decal/stripes/line,
/turf/open/floor/plating/airless,
/area/shuttle/supply)
"i" = (
/turf/closed/wall/mineral/titanium,
/area/shuttle/supply)
"m" = (
/obj/effect/turf_decal/stripes/line,
/turf/open/floor/iron,
/area/shuttle/supply)
"n" = (
/obj/effect/turf_decal/stripes/line{
	dir = 5
	},
/turf/open/floor/iron,
/area/shuttle/supply)
"p" = (
/obj/effect/decal/cleanable/dirt,
/obj/effect/turf_decal/bot,
/obj/item/trash/chips,
/turf/open/floor/iron,
/area/shuttle/supply)
"u" = (
/obj/effect/decal/cleanable/dirt,
/obj/effect/turf_decal/stripes/line,
/turf/open/floor/iron,
/area/shuttle/supply)
"v" = (
/obj/effect/decal/cleanable/dirt,
/obj/effect/turf_decal/bot,
/turf/open/floor/iron,
/area/shuttle/supply)
"w" = (
/obj/effect/turf_decal/stripes/line{
	dir = 8
	},
/obj/machinery/light{
	dir = 8
	},
/obj/machinery/button/door/directional/west{
	id = "cargounload";
	name = "Unloading Doors";
	pixel_y = 8
	},
/turf/open/floor/iron,
/area/shuttle/supply)
"x" = (
/obj/effect/turf_decal/bot,
/obj/item/trash/tray,
/turf/open/floor/iron,
/area/shuttle/supply)
"y" = (
/obj/structure/window/reinforced{
	dir = 1
	},
/obj/structure/shuttle/engine/heater,
/obj/effect/decal/cleanable/dirt,
/obj/effect/turf_decal/stripes/line,
/turf/open/floor/plating/airless,
/area/shuttle/supply)
"z" = (
/obj/effect/decal/cleanable/dirt,
/obj/effect/turf_decal/stripes/line{
	dir = 9
	},
/obj/structure/closet/crate,
/turf/open/floor/iron,
/area/shuttle/supply)
"B" = (
/obj/effect/turf_decal/stripes/line{
	dir = 4
	},
/obj/machinery/light/directional/east,
/turf/open/floor/iron,
/area/shuttle/supply)
"C" = (
/obj/effect/decal/cleanable/oil,
/obj/effect/turf_decal/bot,
/turf/open/floor/iron,
/area/shuttle/supply)
"D" = (
/obj/effect/turf_decal/delivery,
/obj/structure/closet,
/turf/open/floor/iron,
/area/shuttle/supply)
"E" = (
/obj/effect/turf_decal/stripes/line{
	dir = 1
	},
/turf/open/floor/iron,
/area/shuttle/supply)
"F" = (
/obj/effect/decal/cleanable/dirt,
/obj/effect/turf_decal/stripes/line{
	dir = 4
	},
/turf/open/floor/iron,
/area/shuttle/supply)
"G" = (
/obj/effect/decal/cleanable/dirt,
/obj/effect/turf_decal/stripes/line{
	dir = 8
	},
/turf/open/floor/iron,
/area/shuttle/supply)
"K" = (
/obj/effect/decal/cleanable/dirt,
/obj/effect/turf_decal/stripes/line{
	dir = 1
	},
/turf/open/floor/iron,
/area/shuttle/supply)
"L" = (
/obj/structure/shuttle/engine/propulsion,
/obj/effect/turf_decal/stripes/line,
/turf/open/floor/plating/airless,
/area/shuttle/supply)
"M" = (
/obj/effect/turf_decal/bot,
/obj/structure/closet/crate/trashcart,
/obj/item/trash/pistachios,
/turf/open/floor/iron,
/area/shuttle/supply)
"N" = (
/obj/effect/turf_decal/bot,
/obj/item/trash/boritos,
/turf/open/floor/iron,
/area/shuttle/supply)
"P" = (
/obj/structure/shuttle/engine/propulsion/burst/right,
/obj/effect/turf_decal/stripes/line,
/turf/open/floor/plating/airless,
/area/shuttle/supply)
"Q" = (
/obj/machinery/door/airlock/shuttle{
	name = "Supply Shuttle Airlock";
	req_access_txt = "31"
	},
/obj/effect/decal/cleanable/dirt,
/turf/open/floor/plating,
/area/shuttle/supply)
"R" = (
/obj/effect/turf_decal/stripes/line{
	dir = 8
	},
/obj/machinery/button/door/directional/west{
	id = "cargoload";
	name = "Loading Doors";
	pixel_y = -8
	},
/turf/open/floor/iron,
/area/shuttle/supply)
"S" = (
/obj/machinery/door/poddoor{
	id = "cargoload";
	name = "supply dock loading door"
	},
/obj/machinery/conveyor{
	dir = 4;
	id = "CargoLoad"
	},
/turf/open/floor/plating,
/area/shuttle/supply)
"T" = (
/obj/structure/shuttle/engine/propulsion/burst/left,
/obj/effect/turf_decal/stripes/line,
/turf/open/floor/plating/airless,
/area/shuttle/supply)
"U" = (
/obj/effect/turf_decal/stripes/line{
	dir = 4
	},
/obj/item/trash/can/food/beans,
/turf/open/floor/iron,
/area/shuttle/supply)
"V" = (
/obj/machinery/door/airlock/shuttle{
	name = "Supply Shuttle Airlock";
	req_access_txt = "31"
	},
/obj/effect/decal/cleanable/dirt,
/obj/docking_port/mobile/supply{
	dir = 4;
	dwidth = 4
	},
/turf/open/floor/plating,
/area/shuttle/supply)
"W" = (
/obj/effect/turf_decal/bot,
/turf/open/floor/iron,
/area/shuttle/supply)
"X" = (
/obj/effect/decal/cleanable/dirt,
/obj/effect/turf_decal/stripes/line{
	dir = 10
	},
/turf/open/floor/iron,
/area/shuttle/supply)
"Z" = (
/obj/machinery/door/poddoor{
	id = "cargounload";
	name = "supply dock unloading door"
	},
/obj/machinery/conveyor{
	dir = 8;
	id = "CargoOffload"
	},
/turf/open/floor/plating,
/area/shuttle/supply)

(1,1,1) = {"
i
i
Z
i
V
i
i
Q
i
S
i
b
"}
(2,1,1) = {"
i
z
G
G
e
w
R
e
X
d
i
T
"}
(3,1,1) = {"
i
E
W
C
W
W
W
v
u
f
h
L
"}
(4,1,1) = {"
i
c
v
v
v
W
v
N
m
f
y
L
"}
(5,1,1) = {"
i
K
p
W
W
M
W
x
m
D
y
L
"}
(6,1,1) = {"
i
n
F
a
F
B
U
F
g
d
i
P
"}
(7,1,1) = {"
i
i
i
i
i
i
i
i
i
i
i
b
"}
