"aJ" = (/obj/machinery/light{dir = 8},/obj/structure/chair/comfy/shuttle{dir = 4},/obj/effect/turf_decal/stripes/corner{dir = 8},/obj/structure/sign/poster/random{pixel_x = -32},/turf/open/floor/mineral/titanium,/area/space)
"dr" = (/obj/structure/chair/comfy/shuttle{dir = 4},/obj/machinery/status_display/evac{pixel_x = -32},/turf/open/floor/mineral/plastitanium/red/brig,/area/space)
"eA" = (/obj/structure/chair/comfy/shuttle{dir = 4},/turf/open/floor/mineral/titanium,/area/space)
"eE" = (/obj/item/defibrillator/loaded{pixel_y = 5},/obj/machinery/light{dir = 1},/turf/open/floor/mineral/titanium/blue,/area/space)
"eQ" = (/obj/structure/extinguisher_cabinet{pixel_x = 5; pixel_y = 30},/obj/structure/chair/comfy/shuttle{dir = 4},/turf/open/floor/mineral/titanium,/area/space)
"gi" = (/obj/structure/table/reinforced,/obj/item/food/cakeslice/slimecake,/turf/open/floor/mineral/titanium,/area/space)
"gu" = (/turf/template_noop,/area/space)
"hi" = (/obj/structure/table/reinforced,/obj/item/food/cakeslice/clown_slice,/turf/open/floor/mineral/titanium,/area/space)
"hU" = (/obj/structure/chair/comfy/shuttle{dir = 8},/turf/open/floor/mineral/titanium,/area/space)
"iD" = (/obj/structure/chair/comfy/shuttle{dir = 8},/turf/open/floor/mineral/titanium/white,/area/space)
"lt" = (/obj/effect/turf_decal/stripes/line,/obj/effect/turf_decal/stripes/line{dir = 1},/obj/machinery/light{dir = 1},/turf/open/floor/mineral/titanium,/area/space)
"lx" = (/obj/effect/turf_decal/trimline/blue/line,/obj/effect/turf_decal/tile/blue{dir = 4},/obj/effect/turf_decal/tile/blue{dir = 1},/turf/open/floor/mineral/titanium/tiled,/area/space)
"mh" = (/turf/open/floor/mineral/titanium/white,/area/space)
"mw" = (/turf/open/floor/mineral/titanium/blue,/area/space)
"ni" = (/obj/machinery/computer/communications,/turf/open/floor/mineral/titanium/tiled,/area/space)
"nS" = (/obj/machinery/light{dir = 8},/obj/effect/turf_decal/stripes/corner{dir = 1},/obj/structure/chair/comfy/shuttle{dir = 4},/turf/open/floor/mineral/titanium,/area/space)
"nY" = (/obj/machinery/light{dir = 4},/turf/open/floor/mineral/plastitanium/red/brig,/area/space)
"nZ" = (/obj/effect/turf_decal/stripes/line,/obj/effect/turf_decal/stripes/line{dir = 1},/obj/structure/sign/poster/random{pixel_y = 32},/turf/open/floor/mineral/titanium,/area/space)
"pW" = (/obj/structure/table/optable,/obj/item/surgical_drapes,/turf/open/floor/mineral/titanium/blue,/area/space)
"qe" = (/obj/machinery/light,/obj/effect/turf_decal/trimline/blue/line,/obj/effect/turf_decal/tile/blue{dir = 4},/obj/effect/turf_decal/tile/blue{dir = 1},/obj/structure/extinguisher_cabinet{pixel_y = -32},/turf/open/floor/mineral/titanium/tiled,/area/space)
"qz" = (/obj/structure/window{dir = 4},/obj/structure/window{dir = 8; pixel_x = -3},/obj/structure/window,/turf/open/floor/grass,/area/space)
"qW" = (/obj/effect/turf_decal/trimline/blue/line{dir = 5},/obj/effect/turf_decal/tile/blue{dir = 8},/obj/structure/chair/comfy/shuttle,/turf/open/floor/mineral/titanium/tiled,/area/space)
"se" = (/obj/machinery/door/airlock/public/glass{name = "Emergency Shuttle Cockpit"; req_access_txt = "19"},/turf/open/floor/mineral/titanium,/area/space)
"sk" = (/obj/machinery/computer/emergency_shuttle,/turf/open/floor/mineral/titanium/tiled,/area/space)
"sA" = (/obj/structure/table/reinforced,/obj/item/retractor{pixel_x = 4},/obj/item/hemostat{pixel_x = -4},/obj/item/scalpel{pixel_y = 12},/obj/item/cautery,/obj/item/circular_saw{pixel_y = 12},/obj/item/surgicaldrill,/turf/open/floor/mineral/titanium,/area/space)
"ta" = (/obj/structure/table/reinforced,/obj/item/food/cakeslice/brain,/turf/open/floor/mineral/titanium/tiled,/area/space)
"ut" = (/obj/effect/turf_decal/stripes/line{dir = 8},/turf/open/floor/mineral/plastitanium/red/brig,/area/space)
"uD" = (/obj/effect/turf_decal/stripes/end{dir = 4},/turf/open/floor/mineral/titanium,/area/space)
"vW" = (/obj/machinery/light{dir = 4},/obj/effect/turf_decal/stripes/corner,/turf/open/floor/mineral/plastitanium/red/brig,/area/space)
"wK" = (/turf/closed/wall/mineral/titanium/nodiagonal,/area/space)
"xt" = (/obj/structure/window{dir = 4},/obj/structure/window{dir = 1},/obj/structure/window{dir = 8; pixel_x = -3},/turf/open/floor/grass,/area/space)
"xu" = (/obj/structure/shuttle/engine/heater,/obj/structure/window/reinforced{dir = 1},/turf/open/floor/plating/airless,/area/space)
"xQ" = (/mob/living/simple_animal/bot/medbot{name = "\improper emergency medibot"; pixel_x = -3; pixel_y = 2},/turf/open/floor/mineral/titanium/white,/area/space)
"zu" = (/obj/structure/table/reinforced,/obj/machinery/recharger,/obj/structure/sign/poster/random{pixel_x = 32},/turf/open/floor/mineral/plastitanium/red/brig,/area/space)
"zP" = (/obj/machinery/door/airlock/shuttle{name = "Emergency Shuttle Medical"},/turf/open/floor/mineral/titanium,/area/space)
"As" = (/turf/closed/wall/mineral/titanium,/area/space)
"Ca" = (/obj/effect/turf_decal/trimline/blue/line{dir = 10},/obj/effect/turf_decal/tile/blue{dir = 4},/turf/open/floor/mineral/titanium/tiled,/area/space)
"Cf" = (/obj/effect/turf_decal/trimline/blue/line{dir = 6},/obj/effect/turf_decal/tile/blue{dir = 1},/obj/item/storage/firstaid/regular,/turf/open/floor/mineral/titanium/tiled,/area/space)
"DT" = (/turf/open/floor/mineral/titanium,/area/space)
"ES" = (/obj/machinery/stasis,/obj/structure/sign/poster/random{pixel_y = 32},/obj/item/storage/firstaid/regular,/turf/open/floor/mineral/titanium/white,/area/space)
"Fv" = (/obj/machinery/light{dir = 8},/obj/structure/chair/comfy/shuttle{dir = 4},/turf/open/floor/mineral/titanium,/area/space)
"FA" = (/obj/structure/chair/stool,/turf/open/floor/mineral/titanium/blue,/area/space)
"GM" = (/obj/machinery/door/airlock/titanium{name = "Emergency Shuttle Airlock"; req_access_txt = "2"},/turf/open/floor/mineral/plastitanium/red/brig,/area/space)
"Hk" = (/obj/structure/window/reinforced{dir = 1},/obj/structure/shuttle/engine/heater,/turf/open/floor/plating/airless,/area/space)
"Hw" = (/obj/effect/turf_decal/stripes/line,/obj/effect/turf_decal/stripes/line{dir = 1},/turf/open/floor/mineral/titanium,/area/space)
"HZ" = (/obj/effect/turf_decal/trimline/blue/line,/obj/effect/turf_decal/tile/blue{dir = 4},/obj/effect/turf_decal/tile/blue{dir = 1},/obj/structure/sign/poster/random{pixel_y = -32},/turf/open/floor/mineral/titanium/tiled,/area/space)
"IY" = (/obj/machinery/door/airlock/titanium{name = "Escape Shuttle Airlock"},/turf/open/floor/mineral/titanium,/area/space)
"JJ" = (/obj/effect/turf_decal/trimline/blue/line{dir = 9},/obj/effect/turf_decal/tile/blue,/obj/structure/chair/comfy/shuttle,/turf/open/floor/mineral/titanium/tiled,/area/space)
"JL" = (/turf/open/floor/mineral/plastitanium/red/brig,/area/space)
"JV" = (/obj/structure/table/reinforced,/obj/item/restraints/handcuffs{pixel_y = 3},/obj/item/restraints/handcuffs{pixel_y = 7},/turf/open/floor/mineral/plastitanium/red/brig,/area/space)
"KJ" = (/obj/structure/chair/comfy/shuttle{dir = 4},/turf/open/floor/mineral/plastitanium/red/brig,/area/space)
"Lp" = (/obj/machinery/door/airlock/titanium{name = "Escape Shuttle Airlock"},/obj/docking_port/mobile/emergency,/turf/open/floor/mineral/titanium,/area/space)
"LW" = (/obj/structure/chair/comfy/shuttle{dir = 4},/obj/machinery/flasher{id = "shuttle_flasher"; pixel_x = -24; pixel_y = 6},/obj/machinery/button/flasher{id = "shuttle_flasher"; pixel_x = -24; pixel_y = -6},/obj/effect/turf_decal/stripes/corner{dir = 8},/turf/open/floor/mineral/plastitanium/red/brig,/area/space)
"Mr" = (/obj/structure/shuttle/engine/propulsion,/turf/open/floor/plating/airless,/area/space)
"MW" = (/obj/effect/spawner/structure/window/shuttle,/turf/open/floor/plating/airless,/area/space)
"Qy" = (/obj/machinery/door/airlock/titanium{name = "Evac Prisoner Transport"; req_access_txt = "2"},/turf/open/floor/mineral/plastitanium/red/brig,/area/space)
"RX" = (/obj/structure/chair/comfy/shuttle{dir = 8},/obj/effect/turf_decal/stripes/corner,/turf/open/floor/mineral/titanium,/area/space)
"Sf" = (/obj/machinery/shower{dir = 8; name = "Decontamination Shower"},/obj/effect/turf_decal/delivery,/turf/open/floor/mineral/titanium,/area/space)
"Sp" = (/obj/effect/turf_decal/stripes/line{dir = 4},/turf/open/floor/mineral/titanium,/area/space)
"To" = (/obj/machinery/light{dir = 8},/obj/structure/chair/comfy/shuttle{dir = 4},/obj/effect/turf_decal/stripes/corner{dir = 8},/turf/open/floor/mineral/titanium,/area/space)
"TI" = (/obj/machinery/computer/operating{dir = 1},/turf/open/floor/mineral/titanium/white,/area/space)
"TY" = (/obj/effect/turf_decal/stripes/line{dir = 8},/turf/open/floor/mineral/titanium,/area/space)
"UM" = (/obj/effect/turf_decal/stripes/line{dir = 4},/turf/open/floor/mineral/plastitanium/red/brig,/area/space)
"XF" = (/obj/structure/chair/comfy/shuttle{dir = 1},/obj/effect/turf_decal/trimline/blue/line{dir = 1},/obj/effect/turf_decal/tile/blue{dir = 8},/obj/effect/turf_decal/tile/blue,/turf/open/floor/mineral/titanium/tiled,/area/space)
"Yc" = (/obj/effect/turf_decal/stripes/end{dir = 8},/turf/open/floor/mineral/titanium,/area/space)
"YY" = (/obj/structure/chair/comfy/shuttle{dir = 8},/obj/machinery/status_display/evac{dir = 8; pixel_x = 32},/turf/open/floor/mineral/titanium,/area/space)

(1,1,1) = {"
guguAsMWMWMWAsgugu
guAsMWsktaniMWAsgu
guwKJJXFXFXFqWwKgu
guwKCalxqeHZCfwKgu
AswKsesewKwKwKwKAs
wKeQDTDThUwKJVzuwK
wKFvmhmhYYwKdrnYwK
MWeAmhmhhUMWKJJLMW
MWhimhmhhUMWKJJLMW
MWeAmhmhhUMWKJJLMW
wKaJmhmhRXwKLWvWwK
LpTYmhmhSpQyutUMGM
wKnSmhSfwKwKwKwKwK
MWeAmhmhzPmheEESMW
MWgimhiDxtmwxQFAMW
MWeAmhiDqzsApWTIMW
wKTomhiDwKwKwKwKwK
IYYcHwHwnZHwltuDIY
wKxuxuxuHkxuxuxuwK
AsMrMrMrMrMrMrMrAs
"}
