//MAP CONVERTED BY dmm2tgm.py THIS HEADER COMMENT PREVENTS RECONVERSION, DO NOT REMOVE
"br" = (
/obj/structure/closet,
/turf/open/floor/mineral/titanium/yellow,
/area/space)
"em" = (
/obj/machinery/computer/crew,
/turf/open/floor/mineral/titanium/blue,
/area/space)
"ev" = (
/obj/structure/table,
/obj/structure/extinguisher_cabinet{
	pixel_x = 27
	},
/turf/open/floor/mineral/titanium/yellow,
/area/space)
"ez" = (
/obj/machinery/door/airlock/external{
	name = "Emergency Recovery Airlock"
	},
/turf/open/floor/mineral/titanium/white,
/area/space)
"eC" = (
/obj/structure/closet/crate/internals,
/turf/open/floor/plating,
/area/space)
"eO" = (
/obj/structure/chair/comfy/shuttle{
	dir = 4
	},
/turf/open/floor/mineral/plastitanium/red/brig,
/area/space)
"gv" = (
/obj/structure/closet,
/turf/open/floor/mineral/titanium,
/area/space)
"gJ" = (
/obj/machinery/door/airlock/shuttle{
	name = "Emergency Shuttle Airlock"
	},
/obj/docking_port/mobile/emergency{
	dir = 2;
	port_direction = 2
	},
/turf/open/floor/mineral/titanium/white,
/area/space)
"gN" = (
/obj/structure/bed/roller,
/obj/structure/extinguisher_cabinet{
	pixel_y = -30
	},
/turf/open/floor/mineral/titanium/white,
/area/space)
"hf" = (
/obj/machinery/button/flasher{
	id = "cockpit_flasher";
	pixel_x = -28
	},
/turf/open/floor/mineral/titanium/blue,
/area/space)
"hC" = (
/obj/structure/window{
	dir = 8
	},
/obj/structure/window{
	dir = 4
	},
/obj/structure/flora/junglebush/c,
/turf/open/floor/grass,
/area/space)
"jE" = (
/turf/open/floor/mineral/titanium,
/area/space)
"jK" = (
/obj/machinery/computer/emergency_shuttle{
	dir = 8
	},
/turf/open/floor/mineral/titanium,
/area/space)
"jL" = (
/obj/structure/closet/crate/medical,
/turf/open/floor/mineral/titanium,
/area/space)
"mq" = (
/obj/structure/chair/office{
	dir = 1
	},
/turf/open/floor/mineral/titanium/white,
/area/space)
"nA" = (
/obj/structure/window{
	dir = 1
	},
/obj/structure/window{
	dir = 8
	},
/obj/structure/window{
	dir = 4
	},
/obj/structure/flora/ausbushes/fernybush,
/obj/structure/flora/grass/jungle,
/turf/open/floor/grass,
/area/space)
"nN" = (
/obj/structure/window{
	dir = 8
	},
/obj/structure/window{
	dir = 4
	},
/obj/structure/flora/ausbushes/sunnybush,
/turf/open/floor/grass,
/area/space)
"oa" = (
/turf/open/floor/mineral/titanium/blue,
/area/space)
"of" = (
/obj/machinery/shower{
	dir = 1
	},
/obj/effect/turf_decal/delivery,
/turf/open/floor/mineral/titanium,
/area/space)
"oJ" = (
/obj/structure/sink{
	dir = 4;
	pixel_x = 11
	},
/turf/open/floor/mineral/titanium/blue,
/area/space)
"qD" = (
/obj/structure/extinguisher_cabinet{
	pixel_x = 26
	},
/turf/open/floor/mineral/titanium,
/area/space)
"rQ" = (
/obj/machinery/flasher{
	id = "cockpit_flasher";
	pixel_x = 25;
	pixel_y = -5
	},
/turf/open/floor/mineral/titanium,
/area/space)
"sb" = (
/obj/machinery/door/airlock/shuttle{
	name = "Emergency Shuttle Airlock"
	},
/turf/open/floor/mineral/titanium/white,
/area/space)
"sB" = (
/obj/structure/window{
	dir = 8
	},
/obj/structure/window{
	dir = 4
	},
/obj/structure/flora/ausbushes/fernybush,
/obj/structure/flora/ausbushes/sparsegrass,
/turf/open/floor/grass,
/area/space)
"sD" = (
/obj/structure/bed/roller,
/turf/open/floor/mineral/titanium/blue,
/area/space)
"sT" = (
/obj/structure/window{
	dir = 4
	},
/obj/structure/window{
	dir = 8
	},
/obj/structure/flora/ausbushes/pointybush,
/turf/open/floor/grass,
/area/space)
"ts" = (
/turf/open/floor/plating,
/area/space)
"tw" = (
/obj/structure/extinguisher_cabinet{
	pixel_x = -5;
	pixel_y = 30
	},
/turf/open/floor/mineral/titanium,
/area/space)
"um" = (
/obj/structure/table,
/turf/open/floor/mineral/titanium/white,
/area/space)
"uq" = (
/obj/structure/table/reinforced,
/obj/item/hemostat{
	pixel_x = -4
	},
/obj/item/retractor{
	pixel_x = 4
	},
/obj/item/scalpel{
	pixel_y = 12
	},
/turf/open/floor/mineral/titanium/blue,
/area/space)
"uz" = (
/turf/open/floor/mineral/titanium/yellow,
/area/space)
"uN" = (
/obj/structure/table,
/obj/item/lazarus_injector,
/turf/open/floor/mineral/titanium,
/area/space)
"uP" = (
/obj/machinery/door/airlock/shuttle{
	name = "Emergency Shuttle Engi"
	},
/turf/open/floor/mineral/titanium/white,
/area/space)
"vp" = (
/obj/structure/chair/comfy/shuttle{
	dir = 8
	},
/turf/open/floor/mineral/plastitanium/red/brig,
/area/space)
"vR" = (
/turf/closed/wall/mineral/plastitanium,
/area/space)
"wK" = (
/obj/structure/table/reinforced,
/turf/open/floor/mineral/plastitanium/red/brig,
/area/space)
"wN" = (
/obj/structure/table,
/obj/machinery/smartfridge/disks{
	name = "Research Disk Storage";
	pixel_y = 2
	},
/turf/open/floor/mineral/titanium/purple,
/area/space)
"wS" = (
/obj/structure/table,
/turf/open/floor/mineral/titanium,
/area/space)
"xb" = (
/obj/structure/window{
	dir = 8
	},
/obj/structure/window{
	dir = 4
	},
/obj/structure/flora/junglebush/b,
/turf/open/floor/grass,
/area/space)
"xp" = (
/obj/structure/table/reinforced,
/obj/item/surgicaldrill,
/turf/open/floor/mineral/titanium/blue,
/area/space)
"xq" = (
/obj/machinery/door/airlock/shuttle{
	name = "Emergency Shuttle Medical"
	},
/turf/open/floor/mineral/titanium/white,
/area/space)
"xQ" = (
/turf/open/floor/mineral/plastitanium/red/brig,
/area/space)
"yf" = (
/obj/structure/window{
	dir = 8
	},
/obj/structure/window{
	dir = 4
	},
/obj/structure/flora/ausbushes/leafybush,
/obj/structure/flora/ausbushes/brflowers,
/turf/open/floor/grass,
/area/space)
"zJ" = (
/obj/structure/table/reinforced,
/obj/structure/table/reinforced,
/turf/open/floor/mineral/titanium/blue,
/area/space)
"Ad" = (
/obj/structure/extinguisher_cabinet{
	pixel_x = 26
	},
/turf/open/floor/mineral/titanium/yellow,
/area/space)
"AI" = (
/obj/structure/chair/comfy/shuttle{
	dir = 4
	},
/obj/effect/turf_decal/bot,
/turf/open/floor/mineral/titanium,
/area/space)
"Bf" = (
/obj/structure/chair/comfy/shuttle{
	dir = 8
	},
/obj/effect/turf_decal/bot,
/turf/open/floor/mineral/titanium,
/area/space)
"Bx" = (
/obj/structure/window{
	dir = 8
	},
/obj/structure/window{
	dir = 4
	},
/obj/structure/flora/rock/pile,
/obj/structure/flora/ausbushes/ppflowers,
/turf/open/floor/grass,
/area/space)
"BK" = (
/obj/structure/window{
	dir = 8
	},
/obj/structure/window{
	dir = 4
	},
/obj/structure/flora/ausbushes/leafybush,
/obj/structure/flora/ausbushes/ywflowers,
/turf/open/floor/grass,
/area/space)
"BU" = (
/obj/structure/window/reinforced{
	dir = 4
	},
/obj/structure/window/reinforced{
	dir = 1;
	layer = 2.9
	},
/obj/structure/window/reinforced{
	dir = 8
	},
/obj/structure/window/reinforced,
/obj/structure/flora/ausbushes/ppflowers,
/obj/structure/flora/ausbushes/brflowers,
/obj/structure/flora/ausbushes/ywflowers,
/turf/open/floor/grass,
/area/space)
"Cd" = (
/obj/structure/shuttle/engine/heater{
	dir = 8
	},
/obj/structure/window/reinforced{
	dir = 4
	},
/turf/open/floor/plating/airless,
/area/space)
"Df" = (
/turf/open/floor/mech_bay_recharge_floor,
/area/space)
"Dr" = (
/obj/structure/chair/comfy/shuttle{
	dir = 4
	},
/obj/effect/turf_decal/bot,
/obj/machinery/status_display/evac{
	pixel_x = -32
	},
/turf/open/floor/mineral/titanium,
/area/space)
"Ds" = (
/obj/structure/window{
	dir = 8
	},
/obj/structure/window,
/obj/structure/window{
	dir = 4
	},
/obj/structure/flora/grass/jungle,
/obj/structure/flora/ausbushes/brflowers,
/turf/open/floor/grass,
/area/space)
"DZ" = (
/turf/open/floor/circuit,
/area/space)
"Ev" = (
/obj/machinery/door/airlock/shuttle{
	name = "Emergency Shuttle Science"
	},
/turf/open/floor/mineral/titanium/white,
/area/space)
"EK" = (
/obj/structure/chair/comfy/beige{
	dir = 8
	},
/turf/open/floor/mineral/titanium/blue,
/area/space)
"EQ" = (
/obj/structure/extinguisher_cabinet{
	pixel_x = 26
	},
/turf/open/floor/mineral/titanium/purple,
/area/space)
"FR" = (
/obj/structure/extinguisher_cabinet{
	pixel_x = -27
	},
/turf/open/floor/mineral/titanium,
/area/space)
"Gk" = (
/obj/structure/sign/departments/medbay/alt,
/turf/closed/wall/mineral/titanium,
/area/space)
"Go" = (
/obj/structure/chair/comfy/black{
	dir = 8
	},
/turf/open/floor/mineral/titanium/blue,
/area/space)
"Gu" = (
/turf/template_noop,
/area/space)
"Hn" = (
/obj/machinery/computer/communications{
	dir = 8
	},
/turf/open/floor/mineral/titanium,
/area/space)
"Hw" = (
/obj/machinery/door/airlock/shuttle{
	name = "Emergency Shuttle Cargo"
	},
/turf/open/floor/mineral/titanium/white,
/area/space)
"HC" = (
/obj/structure/table/reinforced,
/obj/item/storage/firstaid/fire,
/obj/item/storage/firstaid/brute,
/obj/item/storage/firstaid/o2,
/obj/item/storage/firstaid/toxin,
/turf/open/floor/mineral/titanium/blue,
/area/space)
"HI" = (
/obj/structure/chair/comfy/shuttle{
	dir = 1
	},
/obj/effect/turf_decal/bot,
/turf/open/floor/mineral/titanium,
/area/space)
"HK" = (
/obj/structure/reagent_dispensers/fueltank,
/turf/open/floor/mineral/titanium/yellow,
/area/space)
"Iw" = (
/obj/structure/table,
/turf/open/floor/mineral/titanium/yellow,
/area/space)
"II" = (
/obj/structure/table/reinforced,
/obj/item/storage/fancy/donut_box,
/turf/open/floor/mineral/titanium/blue,
/area/space)
"IK" = (
/turf/open/floor/mineral/titanium/purple,
/area/space)
"Ja" = (
/obj/machinery/stasis,
/turf/open/floor/mineral/titanium/white,
/area/space)
"Jb" = (
/obj/structure/rack,
/obj/item/storage/toolbox/electrical{
	pixel_x = -3;
	pixel_y = 1
	},
/obj/item/storage/toolbox/mechanical{
	pixel_y = -1
	},
/obj/item/storage/toolbox/emergency{
	pixel_x = 3;
	pixel_y = -5
	},
/turf/open/floor/mineral/titanium/white,
/area/space)
"Jc" = (
/obj/item/radio/intercom{
	name = "Station Intercom (General)";
	pixel_x = 28
	},
/turf/open/floor/mineral/titanium/blue,
/area/space)
"Jw" = (
/obj/structure/chair/office/light{
	dir = 8
	},
/turf/open/floor/mineral/titanium/purple,
/area/space)
"JB" = (
/obj/structure/table,
/obj/item/clipboard,
/obj/item/paper,
/turf/open/floor/mineral/titanium/white,
/area/space)
"JJ" = (
/obj/structure/chair/comfy/shuttle{
	dir = 1
	},
/turf/open/floor/mineral/plastitanium/red/brig,
/area/space)
"JS" = (
/obj/structure/table/reinforced,
/obj/machinery/recharger,
/turf/open/floor/mineral/titanium/blue,
/area/space)
"JU" = (
/obj/machinery/status_display/evac,
/turf/closed/wall/mineral/titanium,
/area/space)
"Kw" = (
/obj/structure/table,
/turf/open/floor/plating,
/area/space)
"Ld" = (
/obj/machinery/recharge_station,
/turf/open/floor/circuit,
/area/space)
"Lk" = (
/obj/structure/table/reinforced,
/obj/item/storage/firstaid/medical,
/turf/open/floor/mineral/titanium/blue,
/area/space)
"LX" = (
/obj/machinery/door/airlock/public/glass{
	name = "Emergency Shuttle Cockpit";
	req_access_txt = "19"
	},
/turf/open/floor/mineral/titanium/white,
/area/space)
"Mk" = (
/obj/machinery/door/airlock/external{
	name = "Emergency Recovery Airlock"
	},
/turf/open/floor/plating,
/area/space)
"Mq" = (
/obj/machinery/door/airlock/titanium{
	name = "Emergency Shuttle Airlock";
	req_access_txt = "2"
	},
/turf/open/floor/mineral/plastitanium/red/brig,
/area/space)
"ND" = (
/obj/structure/shuttle/engine/propulsion{
	dir = 8
	},
/turf/open/floor/plating/airless,
/area/space)
"Ob" = (
/obj/structure/chair/comfy/shuttle{
	dir = 4
	},
/obj/machinery/flasher{
	id = "shuttle_flasher";
	pixel_x = -24;
	pixel_y = 6
	},
/obj/machinery/button/flasher{
	id = "shuttle_flasher";
	pixel_x = -24;
	pixel_y = -6
	},
/turf/open/floor/mineral/plastitanium/red/brig,
/area/space)
"Os" = (
/obj/structure/closet/emcloset,
/turf/open/floor/mineral/titanium,
/area/space)
"OQ" = (
/obj/structure/window{
	dir = 1
	},
/obj/structure/window{
	dir = 8
	},
/obj/structure/window{
	dir = 4
	},
/obj/structure/flora/rock/pile,
/obj/structure/flora/ausbushes/ppflowers,
/turf/open/floor/grass,
/area/space)
"Pk" = (
/obj/structure/chair/comfy/shuttle,
/obj/effect/turf_decal/bot,
/turf/open/floor/plating,
/area/space)
"Pw" = (
/obj/item/surgical_drapes,
/obj/structure/table/optable,
/turf/open/floor/mineral/titanium/white,
/area/space)
"PD" = (
/obj/machinery/mech_bay_recharge_port{
	dir = 8
	},
/turf/open/floor/circuit,
/area/space)
"Qg" = (
/obj/structure/window{
	dir = 1
	},
/obj/structure/window{
	dir = 8
	},
/obj/structure/window{
	dir = 4
	},
/obj/structure/flora/grass/both,
/turf/open/floor/grass,
/area/space)
"Qs" = (
/obj/structure/window{
	dir = 8
	},
/obj/structure/window,
/obj/structure/window{
	dir = 4
	},
/obj/structure/flora/ausbushes/leafybush,
/turf/open/floor/grass,
/area/space)
"QH" = (
/obj/structure/window{
	dir = 8
	},
/obj/structure/window{
	dir = 4
	},
/obj/structure/flora/ausbushes/fernybush,
/turf/open/floor/grass,
/area/space)
"RC" = (
/obj/effect/spawner/structure/window/shuttle,
/turf/open/floor/plating,
/area/space)
"Sg" = (
/mob/living/simple_animal/bot/medbot{
	name = "\improper emergency medibot";
	pixel_x = -3;
	pixel_y = 2
	},
/turf/open/floor/mineral/titanium/white,
/area/space)
"Tn" = (
/turf/closed/wall/mineral/titanium/nodiagonal,
/area/space)
"Tr" = (
/obj/structure/table/reinforced,
/obj/item/cautery,
/obj/item/circular_saw,
/turf/open/floor/mineral/titanium/white,
/area/space)
"Uj" = (
/obj/structure/table,
/obj/item/paper_bin,
/obj/item/folder/white,
/obj/item/pen,
/turf/open/floor/mineral/titanium/white,
/area/space)
"Uq" = (
/turf/open/floor/mineral/titanium/white,
/area/space)
"UK" = (
/obj/machinery/computer/mech_bay_power_console{
	dir = 1
	},
/turf/open/floor/circuit,
/area/space)
"Vl" = (
/obj/structure/rack,
/turf/open/floor/mineral/titanium/yellow,
/area/space)
"VK" = (
/obj/structure/chair/comfy/beige{
	dir = 4
	},
/turf/open/floor/mineral/titanium/blue,
/area/space)
"VZ" = (
/obj/structure/table/reinforced,
/obj/item/clothing/gloves/color/latex,
/obj/item/clothing/mask/surgical,
/obj/item/healthanalyzer,
/turf/open/floor/mineral/titanium/white,
/area/space)
"Wb" = (
/obj/structure/extinguisher_cabinet{
	pixel_x = -27
	},
/turf/open/floor/mineral/titanium/white,
/area/space)
"Wh" = (
/obj/machinery/door/airlock/public/glass{
	name = "Emergency Shuttle Brig";
	req_access_txt = "2"
	},
/turf/open/floor/mineral/titanium/white,
/area/space)
"Xx" = (
/obj/machinery/iv_drip,
/turf/open/floor/mineral/titanium/white,
/area/space)
"XF" = (
/obj/structure/chair/comfy/shuttle,
/turf/open/floor/mineral/plastitanium/red/brig,
/area/space)
"XJ" = (
/obj/machinery/computer/operating{
	dir = 1
	},
/turf/open/floor/mineral/titanium/blue,
/area/space)
"XR" = (
/obj/structure/reagent_dispensers/watertank,
/turf/open/floor/mineral/titanium,
/area/space)
"YA" = (
/turf/closed/wall/mineral/titanium,
/area/space)

(1,1,1) = {"
Gu
Gu
Gu
ND
ND
ND
vR
ND
ND
ND
vR
ND
ND
ND
Gu
Gu
Gu
"}
(2,1,1) = {"
Gu
Gu
Gu
YA
Cd
Cd
vR
Cd
Cd
Cd
vR
Cd
Cd
YA
Gu
Gu
Gu
"}
(3,1,1) = {"
Gu
Gu
Gu
YA
Jb
br
AI
AI
RC
HK
AI
AI
jL
YA
Gu
Gu
Gu
"}
(4,1,1) = {"
Gu
Gu
Gu
RC
uz
Uq
uz
Uq
RC
XR
uz
jE
Vl
RC
Gu
Gu
Gu
"}
(5,1,1) = {"
Gu
Gu
YA
YA
um
uz
Uq
uz
RC
uz
jE
uz
uN
YA
YA
Gu
Gu
"}
(6,1,1) = {"
YA
YA
YA
YA
ev
um
uz
Uq
RC
jE
Ad
wS
Iw
YA
YA
YA
YA
"}
(7,1,1) = {"
YA
gv
gv
YA
YA
RC
RC
uP
RC
Hw
YA
YA
YA
YA
Ld
Ld
YA
"}
(8,1,1) = {"
YA
jE
jE
jE
FR
jE
jE
Uq
jE
Uq
jE
YA
wN
Uj
IK
DZ
YA
"}
(9,1,1) = {"
RC
jE
Uq
Uq
Uq
Uq
Uq
Uq
Uq
Uq
Uq
Ev
Uq
Jw
Uq
HI
RC
"}
(10,1,1) = {"
RC
jE
Uq
Bf
Bf
Bf
Bf
Bf
Bf
Uq
jE
YA
IK
Uq
IK
HI
RC
"}
(11,1,1) = {"
YA
jE
Uq
OQ
QH
YA
BK
xb
Ds
Uq
jE
RC
JB
IK
Uq
UK
RC
"}
(12,1,1) = {"
YA
jE
Uq
AI
AI
AI
AI
AI
AI
Uq
jE
YA
IK
Uq
IK
Df
RC
"}
(13,1,1) = {"
sb
Uq
Uq
Uq
Uq
Uq
Uq
Uq
Uq
Uq
Uq
Ev
Uq
EQ
Uq
PD
YA
"}
(14,1,1) = {"
YA
jE
Uq
Bf
Bf
Bf
Bf
Bf
Bf
Uq
jE
YA
YA
YA
YA
YA
YA
"}
(15,1,1) = {"
YA
jE
Uq
Qg
yf
YA
sT
sB
Qs
Uq
jE
Os
YA
eC
Kw
Kw
YA
"}
(16,1,1) = {"
RC
jE
Uq
AI
AI
Dr
AI
AI
AI
Uq
jE
jE
RC
ts
ts
ts
Mk
"}
(17,1,1) = {"
RC
jE
Uq
Uq
Uq
Uq
Uq
Uq
Uq
Uq
Uq
Uq
ez
ts
ts
ts
RC
"}
(18,1,1) = {"
RC
jE
Uq
Bf
Bf
Bf
Bf
Bf
Bf
Uq
jE
jE
RC
Pk
ts
ts
Mk
"}
(19,1,1) = {"
YA
jE
Uq
nA
nN
YA
hC
Bx
Ds
Uq
jE
Os
YA
Pk
ts
ts
YA
"}
(20,1,1) = {"
YA
jE
Uq
AI
AI
AI
AI
AI
AI
Uq
jE
YA
YA
YA
YA
YA
YA
"}
(21,1,1) = {"
gJ
Uq
Uq
Uq
Uq
Uq
Uq
Uq
Uq
Uq
Uq
xq
Wb
xp
Tr
uq
YA
"}
(22,1,1) = {"
YA
jE
Uq
Uq
Uq
Uq
Uq
Uq
Uq
Uq
jE
YA
oa
Uq
oa
Pw
YA
"}
(23,1,1) = {"
YA
jE
jE
jE
qD
jE
jE
Uq
Uq
Uq
jE
RC
Xx
oa
Uq
XJ
RC
"}
(24,1,1) = {"
YA
YA
RC
RC
YA
Tn
jE
Uq
Uq
Uq
jE
Gk
em
mq
oa
VZ
RC
"}
(25,1,1) = {"
YA
Ob
eO
eO
eO
RC
jE
Uq
Uq
Uq
jE
RC
Xx
oa
Uq
of
YA
"}
(26,1,1) = {"
Mq
xQ
xQ
xQ
xQ
Wh
Uq
Uq
Uq
Uq
Uq
xq
oa
Uq
oa
gN
YA
"}
(27,1,1) = {"
RC
XF
xQ
xQ
JJ
RC
rQ
Uq
jE
Uq
jE
YA
Sg
oa
Uq
sD
YA
"}
(28,1,1) = {"
YA
wK
vp
vp
wK
YA
YA
LX
RC
LX
JU
YA
HC
Ja
oJ
Ja
YA
"}
(29,1,1) = {"
YA
YA
RC
YA
YA
BU
hf
Uq
oa
Uq
oa
BU
YA
RC
RC
RC
YA
"}
(30,1,1) = {"
Gu
Gu
Gu
Gu
YA
jE
oa
VK
VK
VK
oa
jE
YA
Gu
Gu
Gu
Gu
"}
(31,1,1) = {"
Gu
Gu
Gu
Gu
RC
oa
oa
JS
II
Lk
oa
oa
RC
Gu
Gu
Gu
Gu
"}
(32,1,1) = {"
Gu
Gu
Gu
Gu
YA
tw
oa
EK
Go
EK
oa
jE
YA
Gu
Gu
Gu
Gu
"}
(33,1,1) = {"
Gu
Gu
Gu
Gu
YA
BU
oa
jE
Jc
jE
oa
BU
YA
Gu
Gu
Gu
Gu
"}
(34,1,1) = {"
Gu
Gu
Gu
Gu
Gu
YA
YA
Hn
zJ
jK
YA
YA
Gu
Gu
Gu
Gu
Gu
"}
(35,1,1) = {"
Gu
Gu
Gu
Gu
Gu
Gu
YA
RC
RC
RC
YA
Gu
Gu
Gu
Gu
Gu
Gu
"}
