"aJ" = (/obj/machinery/light{dir = 8},/obj/structure/chair/comfy/shuttle{dir = 4},/obj/effect/turf_decal/stripes/corner{dir = 8},/obj/structure/sign/poster/random{pixel_x = -32},/turf/open/floor/mineral/titanium,/area/shuttle/escape)
"dr" = (/obj/structure/chair/comfy/shuttle{dir = 4},/obj/machinery/status_display/evac{pixel_x = -32},/turf/open/floor/mineral/plastitanium/red/brig,/area/shuttle/escape)
"eA" = (/obj/structure/chair/comfy/shuttle{dir = 4},/turf/open/floor/mineral/titanium,/area/shuttle/escape)
"eE" = (/obj/item/defibrillator/loaded{pixel_y = 5},/obj/machinery/light{dir = 1},/turf/open/floor/mineral/titanium/blue,/area/shuttle/escape)
"eQ" = (/obj/structure/extinguisher_cabinet{pixel_x = 5; pixel_y = 30},/obj/structure/chair/comfy/shuttle{dir = 4},/turf/open/floor/mineral/titanium,/area/shuttle/escape)
"gi" = (/obj/structure/table/reinforced,/obj/item/food/cakeslice/slimecake,/turf/open/floor/mineral/titanium,/area/shuttle/escape)
"gu" = (/turf/template_noop,/area/space)
"hi" = (/obj/structure/table/reinforced,/obj/item/food/cakeslice/clown_slice,/turf/open/floor/mineral/titanium,/area/shuttle/escape)
"hU" = (/obj/structure/chair/comfy/shuttle{dir = 8},/turf/open/floor/mineral/titanium,/area/shuttle/escape)
"iD" = (/obj/structure/chair/comfy/shuttle{dir = 8},/turf/open/floor/mineral/titanium/white,/area/shuttle/escape)
"lt" = (/obj/effect/turf_decal/stripes/line,/obj/effect/turf_decal/stripes/line{dir = 1},/obj/machinery/light{dir = 1},/turf/open/floor/mineral/titanium,/area/shuttle/escape)
"lx" = (/obj/effect/turf_decal/trimline/blue/line,/obj/effect/turf_decal/tile/blue{dir = 4},/obj/effect/turf_decal/tile/blue{dir = 1},/turf/open/floor/mineral/titanium/tiled,/area/shuttle/escape)
"mh" = (/turf/open/floor/mineral/titanium/white,/area/shuttle/escape)
"mw" = (/turf/open/floor/mineral/titanium/blue,/area/shuttle/escape)
"ni" = (/obj/machinery/computer/communications,/turf/open/floor/mineral/titanium/tiled,/area/shuttle/escape)
"nS" = (/obj/machinery/light{dir = 8},/obj/effect/turf_decal/stripes/corner{dir = 1},/obj/structure/chair/comfy/shuttle{dir = 4},/turf/open/floor/mineral/titanium,/area/shuttle/escape)
"nY" = (/obj/machinery/light{dir = 4},/turf/open/floor/mineral/plastitanium/red/brig,/area/shuttle/escape)
"nZ" = (/obj/effect/turf_decal/stripes/line,/obj/effect/turf_decal/stripes/line{dir = 1},/obj/structure/sign/poster/random{pixel_y = 32},/turf/open/floor/mineral/titanium,/area/shuttle/escape)
"pW" = (/obj/structure/table/optable,/obj/item/surgical_drapes,/turf/open/floor/mineral/titanium/blue,/area/shuttle/escape)
"qe" = (/obj/machinery/light,/obj/effect/turf_decal/trimline/blue/line,/obj/effect/turf_decal/tile/blue{dir = 4},/obj/effect/turf_decal/tile/blue{dir = 1},/obj/structure/extinguisher_cabinet{pixel_y = -32},/turf/open/floor/mineral/titanium/tiled,/area/shuttle/escape)
"qz" = (/obj/structure/window{dir = 4},/obj/structure/window{dir = 8; pixel_x = -3},/obj/structure/window,/turf/open/floor/grass,/area/shuttle/escape)
"qW" = (/obj/effect/turf_decal/trimline/blue/line{dir = 5},/obj/effect/turf_decal/tile/blue{dir = 8},/obj/structure/chair/comfy/shuttle,/turf/open/floor/mineral/titanium/tiled,/area/shuttle/escape)
"se" = (/obj/machinery/door/airlock/public/glass{name = "Emergency Shuttle Cockpit"; req_access_txt = "19"},/turf/open/floor/mineral/titanium,/area/shuttle/escape)
"sk" = (/obj/machinery/computer/emergency_shuttle,/turf/open/floor/mineral/titanium/tiled,/area/shuttle/escape)
"sA" = (/obj/structure/table/reinforced,/obj/item/storage/backpack/duffelbag/med/surgery,/turf/open/floor/mineral/titanium,/area/shuttle/escape)
"ta" = (/obj/structure/table/reinforced,/obj/item/food/cakeslice/brain,/turf/open/floor/mineral/titanium/tiled,/area/shuttle/escape)
"ut" = (/obj/effect/turf_decal/stripes/line{dir = 8},/turf/open/floor/mineral/plastitanium/red/brig,/area/shuttle/escape)
"uD" = (/obj/effect/turf_decal/stripes/end{dir = 4},/turf/open/floor/mineral/titanium,/area/shuttle/escape)
"vW" = (/obj/machinery/light{dir = 4},/obj/effect/turf_decal/stripes/corner,/turf/open/floor/mineral/plastitanium/red/brig,/area/shuttle/escape)
"wK" = (/turf/closed/wall/mineral/titanium/nodiagonal,/area/shuttle/escape)
"xt" = (/obj/structure/window{dir = 4},/obj/structure/window{dir = 1},/obj/structure/window{dir = 8; pixel_x = -3},/turf/open/floor/grass,/area/shuttle/escape)
"xu" = (/obj/structure/shuttle/engine/heater,/obj/structure/window/reinforced{dir = 1},/turf/open/floor/plating/airless,/area/shuttle/escape)
"xQ" = (/mob/living/simple_animal/bot/medbot{name = "\improper emergency medibot"; pixel_x = -3; pixel_y = 2},/turf/open/floor/mineral/titanium/white,/area/shuttle/escape)
"zu" = (/obj/structure/table/reinforced,/obj/machinery/recharger,/obj/structure/sign/poster/random{pixel_x = 32},/turf/open/floor/mineral/plastitanium/red/brig,/area/shuttle/escape)
"zP" = (/obj/machinery/door/airlock/shuttle{name = "Emergency Shuttle Medical"},/turf/open/floor/mineral/titanium,/area/shuttle/escape)
"As" = (/turf/closed/wall/mineral/titanium,/area/shuttle/escape)
"Ca" = (/obj/effect/turf_decal/trimline/blue/line{dir = 10},/obj/effect/turf_decal/tile/blue{dir = 4},/turf/open/floor/mineral/titanium/tiled,/area/shuttle/escape)
"Cf" = (/obj/effect/turf_decal/trimline/blue/line{dir = 6},/obj/effect/turf_decal/tile/blue{dir = 1},/obj/item/storage/firstaid/regular,/turf/open/floor/mineral/titanium/tiled,/area/shuttle/escape)
"DT" = (/turf/open/floor/mineral/titanium,/area/shuttle/escape)
"ES" = (/obj/machinery/stasis,/obj/structure/sign/poster/random{pixel_y = 32},/obj/item/storage/firstaid/regular,/turf/open/floor/mineral/titanium/white,/area/shuttle/escape)
"Fv" = (/obj/machinery/light{dir = 8},/obj/structure/chair/comfy/shuttle{dir = 4},/turf/open/floor/mineral/titanium,/area/shuttle/escape)
"FA" = (/obj/structure/chair/stool,/turf/open/floor/mineral/titanium/blue,/area/shuttle/escape)
"GM" = (/obj/machinery/door/airlock/titanium{name = "Emergency Shuttle Airlock"; req_access_txt = "2"},/turf/open/floor/mineral/plastitanium/red/brig,/area/shuttle/escape)
"Hk" = (/obj/structure/window/reinforced{dir = 1},/obj/structure/shuttle/engine/heater,/turf/open/floor/plating/airless,/area/shuttle/escape)
"Hw" = (/obj/effect/turf_decal/stripes/line,/obj/effect/turf_decal/stripes/line{dir = 1},/turf/open/floor/mineral/titanium,/area/shuttle/escape)
"HZ" = (/obj/effect/turf_decal/trimline/blue/line,/obj/effect/turf_decal/tile/blue{dir = 4},/obj/effect/turf_decal/tile/blue{dir = 1},/obj/structure/sign/poster/random{pixel_y = -32},/turf/open/floor/mineral/titanium/tiled,/area/shuttle/escape)
"IY" = (/obj/machinery/door/airlock/titanium{name = "Escape Shuttle Airlock"},/turf/open/floor/mineral/titanium,/area/shuttle/escape)
"JJ" = (/obj/effect/turf_decal/trimline/blue/line{dir = 9},/obj/effect/turf_decal/tile/blue,/obj/structure/chair/comfy/shuttle,/turf/open/floor/mineral/titanium/tiled,/area/shuttle/escape)
"JL" = (/turf/open/floor/mineral/plastitanium/red/brig,/area/shuttle/escape)
"JV" = (/obj/structure/table/reinforced,/obj/item/restraints/handcuffs{pixel_y = 3},/obj/item/restraints/handcuffs{pixel_y = 7},/turf/open/floor/mineral/plastitanium/red/brig,/area/shuttle/escape)
"KJ" = (/obj/structure/chair/comfy/shuttle{dir = 4},/turf/open/floor/mineral/plastitanium/red/brig,/area/shuttle/escape)
"Lp" = (/obj/machinery/door/airlock/titanium{name = "Escape Shuttle Airlock"},/obj/docking_port/mobile/emergency{dwidth = 4; height = 20; width = 9},/turf/open/floor/mineral/titanium,/area/shuttle/escape)
"LW" = (/obj/structure/chair/comfy/shuttle{dir = 4},/obj/machinery/flasher{id = "shuttle_flasher"; pixel_x = -24; pixel_y = 6},/obj/machinery/button/flasher{id = "shuttle_flasher"; pixel_x = -24; pixel_y = -6},/obj/effect/turf_decal/stripes/corner{dir = 8},/turf/open/floor/mineral/plastitanium/red/brig,/area/shuttle/escape)
"Mr" = (/obj/structure/shuttle/engine/propulsion,/turf/open/floor/plating/airless,/area/shuttle/escape)
"MW" = (/obj/effect/spawner/structure/window/shuttle,/turf/open/floor/plating/airless,/area/shuttle/escape)
"Qy" = (/obj/machinery/door/airlock/titanium{name = "Evac Prisoner Transport"; req_access_txt = "2"},/turf/open/floor/mineral/plastitanium/red/brig,/area/shuttle/escape)
"RX" = (/obj/structure/chair/comfy/shuttle{dir = 8},/obj/effect/turf_decal/stripes/corner,/turf/open/floor/mineral/titanium,/area/shuttle/escape)
"Sf" = (/obj/machinery/shower{dir = 8; name = "Decontamination Shower"},/obj/effect/turf_decal/delivery,/turf/open/floor/mineral/titanium,/area/shuttle/escape)
"Sp" = (/obj/effect/turf_decal/stripes/line{dir = 4},/turf/open/floor/mineral/titanium,/area/shuttle/escape)
"To" = (/obj/machinery/light{dir = 8},/obj/structure/chair/comfy/shuttle{dir = 4},/obj/effect/turf_decal/stripes/corner{dir = 8},/turf/open/floor/mineral/titanium,/area/shuttle/escape)
"TI" = (/obj/machinery/computer/operating{dir = 1},/turf/open/floor/mineral/titanium/white,/area/shuttle/escape)
"TY" = (/obj/effect/turf_decal/stripes/line{dir = 8},/turf/open/floor/mineral/titanium,/area/shuttle/escape)
"UM" = (/obj/effect/turf_decal/stripes/line{dir = 4},/turf/open/floor/mineral/plastitanium/red/brig,/area/shuttle/escape)
"XF" = (/obj/structure/chair/comfy/shuttle{dir = 1},/obj/effect/turf_decal/trimline/blue/line{dir = 1},/obj/effect/turf_decal/tile/blue{dir = 8},/obj/effect/turf_decal/tile/blue,/turf/open/floor/mineral/titanium/tiled,/area/shuttle/escape)
"Yc" = (/obj/effect/turf_decal/stripes/end{dir = 8},/turf/open/floor/mineral/titanium,/area/shuttle/escape)
"YY" = (/obj/structure/chair/comfy/shuttle{dir = 8},/obj/machinery/status_display/evac{dir = 8; pixel_x = 32},/turf/open/floor/mineral/titanium,/area/shuttle/escape)

(1,1,1) = {"
guguAsMWMWMWAsgugu
guAsMWsktaniMWAsgu
guAsJJXFXFXFqWAsgu
guAsCalxqeHZCfAsgu
AsAsseseAsAsAsAsAs
AseQDTDThUwKJVzuAs
AsFvmhmhYYwKdrnYAs
MWeAmhmhhUMWKJJLMW
MWhimhmhhUMWKJJLMW
MWeAmhmhhUMWKJJLMW
AsaJmhmhRXwKLWvWAs
LpTYmhmhSpQyutUMGM
AsnSmhSfwKwKwKwKAs
MWeAmhmhzPmheEESMW
MWgimhiDxtmwxQFAMW
MWeAmhiDqzsApWTIMW
AsTomhiDwKwKwKwKAs
IYYcHwHwnZHwltuDIY
AsxuxuxuHkxuxuxuAs
AsMrMrMrMrMrMrMrAs
"}
