"a" = (/turf/template_noop,/area/template_noop)
"b" = (/obj/effect/spawner/structure/window/shuttle,/turf/open/floor/mineral/plastitanium,/area/shuttle/escape)
"c" = (/obj/structure/chair/comfy/shuttle,/obj/machinery/light/dim{dir = 1},/turf/open/floor/mineral/plastitanium/red/brig,/area/shuttle/escape)
"d" = (/obj/item/radio/intercom{dir = 4; name = "Station Intercom (General)"; pixel_y = 27},/turf/open/floor/mineral/titanium/white,/area/shuttle/escape)
"e" = (/obj/structure/chair/comfy/shuttle{dir = 1},/obj/machinery/light/dim,/turf/open/floor/mineral/plastitanium/red/brig,/area/shuttle/escape)
"f" = (/obj/structure/chair/comfy/shuttle{dir = 1},/obj/machinery/button/door{id = "wet"; name = "Magic Button"; pixel_x = 24; pixel_y = 8},/turf/open/floor/mineral/titanium/white,/area/shuttle/escape)
"j" = (/obj/structure/chair/comfy/shuttle,/turf/open/floor/mineral/titanium/white,/area/shuttle/escape)
"k" = (/obj/machinery/status_display/evac{pixel_y = -32},/obj/machinery/light/dim,/turf/open/floor/mineral/titanium/white,/area/shuttle/escape)
"l" = (/obj/structure/chair/comfy/shuttle,/obj/machinery/status_display/evac{pixel_y = 32},/turf/open/floor/mineral/titanium/white,/area/shuttle/escape)
"m" = (/obj/structure/chair/comfy/shuttle,/obj/item/radio/intercom{dir = 4; name = "Station Intercom (General)"; pixel_y = 27},/turf/open/floor/mineral/titanium/white,/area/shuttle/escape)
"n" = (/obj/machinery/door/airlock/titanium{name = "Emergency Shuttle Airlock"},/turf/open/floor/noslip,/area/shuttle/escape)
"o" = (/obj/machinery/door/airlock/titanium{name = "Emergency Shuttle Airlock"},/obj/docking_port/mobile/emergency{dir = 2; dwidth = 6; name = "Shitcurity Emergency Shuttle"; port_direction = 4; preferred_direction = 8},/turf/open/floor/noslip,/area/shuttle/escape)
"r" = (/obj/machinery/door/poddoor{id = "wet"; name = "Surprise!"},/turf/open/floor/mineral/titanium/white,/area/shuttle/escape)
"s" = (/obj/item/clothing/suit/caution/slippery,/turf/open/floor/mineral/titanium/white,/area/shuttle/escape)
"t" = (/obj/effect/turf_decal/stripes/line{dir = 4},/obj/machinery/light/dim{dir = 4},/turf/open/floor/mineral/plastitanium,/area/shuttle/escape)
"u" = (/obj/item/storage/firstaid/regular,/obj/structure/table,/turf/open/floor/mineral/titanium/white,/area/shuttle/escape)
"v" = (/obj/structure/chair/comfy/shuttle,/turf/open/floor/mineral/plastitanium/red/brig,/area/shuttle/escape)
"w" = (/obj/structure/chair/comfy/shuttle,/obj/machinery/light/dim{dir = 1},/turf/open/floor/mineral/titanium/white,/area/shuttle/escape)
"y" = (/obj/machinery/computer/emergency_shuttle{dir = 4},/turf/open/floor/mineral/titanium/white,/area/shuttle/escape)
"z" = (/obj/structure/chair/comfy/shuttle{dir = 1},/turf/open/floor/mineral/titanium/white,/area/shuttle/escape)
"A" = (/obj/structure/chair/comfy/shuttle{dir = 1},/obj/machinery/light/dim,/turf/open/floor/mineral/titanium/white,/area/shuttle/escape)
"B" = (/obj/structure/chair/comfy/shuttle{dir = 1},/turf/open/floor/mineral/plastitanium/red/brig,/area/shuttle/escape)
"C" = (/obj/item/radio/intercom{dir = 4; name = "Station Intercom (General)"; pixel_y = 27},/obj/machinery/light/dim{dir = 1},/turf/open/floor/mineral/titanium/white,/area/shuttle/escape)
"D" = (/obj/machinery/status_display/evac{pixel_y = 32},/obj/structure/chair/comfy/shuttle,/turf/open/floor/mineral/titanium/white,/area/shuttle/escape)
"E" = (/obj/machinery/computer/arcade/amputation{dir = 4},/turf/open/floor/mineral/titanium/white,/area/shuttle/escape)
"F" = (/turf/closed/wall/mineral/titanium,/area/shuttle/escape)
"G" = (/obj/machinery/computer/communications{dir = 4},/turf/open/floor/mineral/titanium/white,/area/shuttle/escape)
"I" = (/turf/open/floor/mineral/plastitanium,/area/shuttle/escape)
"K" = (/turf/closed/wall/mineral/titanium/interior,/area/shuttle/escape)
"M" = (/turf/open/floor/mineral/plastitanium/red/brig,/area/shuttle/escape)
"N" = (/turf/open/floor/mineral/titanium/white,/area/shuttle/escape)
"O" = (/obj/structure/chair/comfy/shuttle{dir = 1},/obj/machinery/status_display/evac{pixel_y = -32},/turf/open/floor/mineral/titanium/white,/area/shuttle/escape)
"P" = (/turf/closed/wall/mineral/plastitanium,/area/shuttle/escape)
"Q" = (/obj/machinery/atmospherics/miner/water_vapor,/turf/open/floor/mineral/plastitanium,/area/shuttle/escape)
"R" = (/obj/structure/shuttle/engine/propulsion{dir = 4},/turf/template_noop,/area/shuttle/escape)
"S" = (/obj/item/radio/intercom{name = "Station Intercom (General)"; pixel_y = -31},/turf/open/floor/mineral/titanium/white,/area/shuttle/escape)
"U" = (/obj/structure/shuttle/engine/heater{dir = 4},/obj/structure/window/reinforced{dir = 8},/turf/open/floor/plating,/area/shuttle/escape)
"V" = (/obj/structure/chair/comfy/shuttle,/obj/structure/chair/comfy/shuttle,/turf/open/floor/mineral/titanium/white,/area/shuttle/escape)
"W" = (/obj/effect/turf_decal/stripes/line{dir = 4},/turf/open/floor/mineral/plastitanium,/area/shuttle/escape)
"Z" = (/obj/machinery/status_display/evac{pixel_y = -32},/obj/structure/chair/comfy/shuttle{dir = 1},/turf/open/floor/mineral/plastitanium/red/brig,/area/shuttle/escape)

(1,1,1) = {"
aaaaFFFnbnFbbbFobnPPPa
aaaFFNNNNNdNsNNNNNrIPa
aFFFNNzzzAzzzzOAzfPIUR
FFCNNNKKbKFKKKFKbPPWUR
bGNNNNbVjwDmbvvcvbIWUR
byNuNNNNNNNNNMMMMbQtPa
bENNNNbzzAzzbBZeBbIWUR
FFkNNNKKbKFKKKFKbPPWUR
aFFFNNjjjwljjjjwjjPIUR
aaaFFNNNNNSNNNNNNNrIPa
aaaaFFFbbbFbbbFbbnPPPa
"}
