//MAP CONVERTED BY dmm2tgm.py THIS HEADER COMMENT PREVENTS RECONVERSION, DO NOT REMOVE
"aI" = (
/obj/machinery/disposal/delivery_chute{
	dir = 4
	},
/obj/machinery/status_display/evac/directional/west,
/obj/structure/disposalpipe/trunk{
	dir = 8
	},
/turf/open/floor/mineral/plastitanium/red/brig,
/area/shuttle/escape)
"aS" = (
/obj/structure/disposalpipe/trunk{
	dir = 1
	},
/obj/machinery/light/dim/directional/north,
/turf/open/floor/plating,
/area/shuttle/escape)
"eg" = (
/obj/structure/disposalpipe/segment{
	dir = 4
	},
/turf/open/floor/engine,
/area/shuttle/escape)
"fy" = (
/obj/structure/disposalpipe/junction/yjunction,
/turf/closed/wall/mineral/titanium,
/area/shuttle/escape)
"gc" = (
/obj/machinery/disposal/delivery_chute{
	dir = 1
	},
/obj/structure/disposalpipe/trunk{
	dir = 8
	},
/turf/open/floor/mineral/plastitanium/red/brig,
/area/shuttle/escape)
"gD" = (
/obj/structure/chair/comfy/shuttle{
	dir = 1
	},
/obj/structure/disposalpipe/segment{
	dir = 5
	},
/turf/open/floor/engine,
/area/shuttle/escape)
"gU" = (
/obj/machinery/computer/arcade/amputation{
	dir = 4
	},
/turf/open/floor/mineral/titanium/white,
/area/shuttle/escape)
"hl" = (
/obj/structure/shuttle/engine/propulsion{
	dir = 4
	},
/obj/machinery/atmospherics/components/unary/outlet_injector/on{
	dir = 8
	},
/turf/open/floor/plating,
/area/shuttle/escape)
"jl" = (
/obj/machinery/conveyor/auto/random{
	activation_chance = 30;
	dir = 4
	},
/obj/machinery/atmospherics/components/unary/vent_scrubber/on,
/turf/open/floor/engine,
/area/shuttle/escape)
"kZ" = (
/obj/structure/disposalpipe/segment,
/turf/open/floor/engine,
/area/shuttle/escape)
"lk" = (
/obj/machinery/conveyor/auto/random{
	dir = 4
	},
/obj/machinery/status_display/evac/directional/south,
/obj/machinery/light/dim/directional/south,
/obj/structure/disposalpipe/trunk{
	dir = 1
	},
/turf/open/floor/plating,
/area/shuttle/escape)
"mb" = (
/turf/open/floor/engine/miasma{
	initial_gas_mix = "miasma=500;TEMP=293.15"
	},
/area/shuttle/escape)
"nz" = (
/obj/structure/disposalpipe/junction/flip{
	dir = 8
	},
/turf/open/floor/engine,
/area/shuttle/escape)
"op" = (
/obj/structure/disposalpipe/trunk,
/obj/machinery/status_display/evac/directional/east,
/turf/open/floor/plating,
/area/shuttle/escape)
"oJ" = (
/obj/machinery/disposal/delivery_chute{
	dir = 1
	},
/obj/structure/disposalpipe/trunk,
/obj/machinery/light/dim/directional/south,
/turf/open/floor/mineral/plastitanium,
/area/shuttle/escape)
"pH" = (
/obj/machinery/atmospherics/pipe/smart/manifold4w/scrubbers/hidden,
/turf/closed/wall/mineral/titanium,
/area/shuttle/escape)
"qd" = (
/obj/machinery/disposal/delivery_chute{
	dir = 4
	},
/obj/machinery/status_display/evac/directional/west,
/obj/structure/disposalpipe/trunk,
/turf/open/floor/engine,
/area/shuttle/escape)
"qh" = (
/obj/structure/chair/comfy/shuttle,
/obj/structure/disposalpipe/segment{
	dir = 9
	},
/turf/open/floor/mineral/plastitanium/red/brig,
/area/shuttle/escape)
"qw" = (
/obj/structure/chair/comfy/shuttle,
/obj/structure/disposalpipe/segment,
/turf/open/floor/engine,
/area/shuttle/escape)
"qD" = (
/obj/structure/disposalpipe/segment{
	dir = 4
	},
/obj/structure/disposalpipe/segment,
/turf/closed/wall/mineral/titanium,
/area/shuttle/escape)
"qF" = (
/obj/machinery/conveyor/auto/random{
	dir = 4
	},
/turf/open/floor/engine,
/area/shuttle/escape)
"rf" = (
/obj/machinery/disposal/delivery_chute{
	dir = 4
	},
/obj/machinery/status_display/evac/directional/west,
/obj/structure/disposalpipe/trunk{
	dir = 1
	},
/turf/open/floor/engine,
/area/shuttle/escape)
"su" = (
/obj/structure/disposalpipe/segment{
	dir = 4
	},
/obj/structure/chair/comfy/shuttle{
	dir = 1
	},
/turf/open/floor/engine,
/area/shuttle/escape)
"ta" = (
/obj/structure/disposalpipe/junction{
	dir = 4
	},
/turf/closed/wall/mineral/titanium,
/area/shuttle/escape)
"vf" = (
/turf/closed/wall/mineral/titanium/nodiagonal,
/area/shuttle/escape)
"vl" = (
/turf/open/floor/engine,
/area/shuttle/escape)
"vn" = (
/obj/structure/sign/warning/radiation,
/turf/closed/wall/mineral/titanium,
/area/shuttle/escape)
"wH" = (
/obj/structure/disposalpipe/segment{
	dir = 4
	},
/turf/closed/wall/mineral/titanium,
/area/shuttle/escape)
"wX" = (
/obj/structure/disposalpipe/junction/yjunction{
	dir = 4
	},
/turf/closed/wall/mineral/titanium,
/area/shuttle/escape)
"xx" = (
/obj/machinery/door/airlock/titanium{
	name = "Emergency Shuttle Airlock"
	},
/turf/open/floor/mineral/plastitanium,
/area/shuttle/escape)
"xH" = (
/turf/open/floor/mineral/plastitanium/red/brig,
/area/shuttle/escape)
"xO" = (
/obj/machinery/conveyor/auto/random{
	dir = 4
	},
/obj/machinery/light/dim/directional/north,
/turf/open/floor/engine,
/area/shuttle/escape)
"ya" = (
/obj/structure/fans/tiny/invisible,
/obj/machinery/conveyor/auto/random{
	activation_chance = 30;
	dir = 4
	},
/turf/open/floor/engine,
/area/shuttle/escape)
"yl" = (
/obj/structure/disposalpipe/segment{
	dir = 6
	},
/turf/closed/wall/mineral/titanium,
/area/shuttle/escape)
"yC" = (
/obj/item/radio/intercom/directional/east,
/turf/open/floor/mineral/titanium/white,
/area/shuttle/escape)
"zE" = (
/obj/machinery/computer/emergency_shuttle{
	dir = 4
	},
/turf/open/floor/mineral/titanium/white,
/area/shuttle/escape)
"zI" = (
/obj/machinery/disposal/delivery_chute,
/obj/structure/disposalpipe/trunk{
	dir = 1
	},
/obj/machinery/door/window/southleft,
/turf/open/floor/mineral/titanium/white,
/area/shuttle/escape)
"Bk" = (
/obj/structure/disposalpipe/segment,
/turf/closed/wall/mineral/titanium,
/area/shuttle/escape)
"BL" = (
/obj/structure/disposalpipe/segment{
	dir = 9
	},
/turf/closed/wall/mineral/titanium,
/area/shuttle/escape)
"Ch" = (
/obj/machinery/door/airlock/titanium{
	name = "Emergency Shuttle Airlock"
	},
/obj/docking_port/mobile/emergency{
	dir = 2;
	dwidth = 6;
	name = "Perfectly Normal Emergency Shuttle";
	port_direction = 4;
	preferred_direction = 8
	},
/turf/open/floor/mineral/plastitanium,
/area/shuttle/escape)
"DB" = (
/obj/structure/chair/comfy/shuttle{
	dir = 1
	},
/obj/structure/disposalpipe/segment{
	dir = 4
	},
/obj/machinery/light/dim/directional/south,
/turf/open/floor/engine,
/area/shuttle/escape)
"DC" = (
/obj/structure/disposalpipe/trunk{
	dir = 1
	},
/turf/open/floor/plating,
/area/shuttle/escape)
"DF" = (
/obj/item/greentext,
/obj/structure/disposalpipe/segment{
	dir = 4
	},
/turf/open/floor/engine/n2o,
/area/shuttle/escape)
"Ei" = (
/obj/effect/spawner/structure/window/shuttle,
/turf/open/floor/mineral/plastitanium,
/area/shuttle/escape)
"ED" = (
/obj/machinery/light/dim/directional/east,
/turf/open/floor/mineral/titanium/white,
/area/shuttle/escape)
"Fn" = (
/obj/machinery/atmospherics/pipe/smart/manifold4w/scrubbers/hidden,
/turf/closed/wall/mineral/titanium/interior,
/area/shuttle/escape)
"Fx" = (
/turf/closed/wall/mineral/titanium/interior,
/area/shuttle/escape)
"FR" = (
/obj/structure/disposalpipe/segment{
	dir = 4
	},
/obj/machinery/light/dim/directional/north,
/obj/structure/disposalpipe/trunk{
	dir = 1
	},
/turf/open/floor/plating,
/area/shuttle/escape)
"FU" = (
/obj/structure/disposalpipe/segment{
	dir = 5
	},
/turf/open/floor/engine,
/area/shuttle/escape)
"GJ" = (
/obj/structure/chair/comfy/shuttle,
/turf/open/floor/mineral/plastitanium/red/brig,
/area/shuttle/escape)
"GQ" = (
/obj/structure/chair/comfy/shuttle{
	dir = 1
	},
/obj/structure/disposalpipe/segment{
	dir = 4
	},
/turf/open/floor/mineral/plastitanium/red/brig,
/area/shuttle/escape)
"HJ" = (
/obj/machinery/disposal/delivery_chute{
	dir = 4
	},
/obj/machinery/status_display/evac/directional/west,
/obj/structure/disposalpipe/trunk{
	dir = 4
	},
/turf/open/floor/engine,
/area/shuttle/escape)
"HO" = (
/obj/structure/chair/comfy/shuttle{
	dir = 8
	},
/turf/open/floor/mineral/titanium/white,
/area/shuttle/escape)
"Jt" = (
/mob/living/simple_animal/pet/dog/corgi/narsie,
/turf/open/floor/cult,
/area/shuttle/escape)
"JR" = (
/obj/structure/chair/comfy/shuttle,
/obj/structure/disposalpipe/segment{
	dir = 5
	},
/turf/open/floor/engine,
/area/shuttle/escape)
"KL" = (
/obj/effect/spawner/structure/window/shuttle,
/obj/machinery/atmospherics/pipe/smart/manifold4w/scrubbers/hidden,
/turf/open/floor/mineral/plastitanium,
/area/shuttle/escape)
"KY" = (
/obj/machinery/light/dim/directional/north,
/obj/structure/disposalpipe/trunk{
	dir = 1
	},
/turf/open/floor/plating,
/area/shuttle/escape)
"Lh" = (
/obj/structure/disposalpipe/segment{
	dir = 9
	},
/turf/open/floor/engine,
/area/shuttle/escape)
"Mu" = (
/obj/machinery/light/dim/directional/south,
/obj/structure/disposalpipe/segment{
	dir = 4
	},
/obj/structure/chair/comfy/shuttle{
	dir = 1
	},
/turf/open/floor/mineral/plastitanium/red/brig,
/area/shuttle/escape)
"Mw" = (
/obj/structure/chair/comfy/shuttle{
	dir = 1
	},
/obj/structure/disposalpipe/segment{
	dir = 4
	},
/turf/open/floor/engine,
/area/shuttle/escape)
"PA" = (
/obj/structure/chair/comfy/shuttle,
/obj/structure/disposalpipe/segment,
/obj/structure/disposalpipe/segment{
	dir = 4
	},
/turf/open/floor/engine,
/area/shuttle/escape)
"Qh" = (
/obj/machinery/disposal/delivery_chute{
	dir = 4
	},
/obj/structure/disposalpipe/trunk{
	dir = 8
	},
/turf/open/floor/engine,
/area/shuttle/escape)
"Rh" = (
/obj/structure/shuttle/engine/heater{
	dir = 4
	},
/obj/structure/window/reinforced{
	dir = 8
	},
/obj/machinery/atmospherics/pipe/smart/manifold4w/scrubbers/hidden,
/turf/open/floor/mineral/plastitanium,
/area/shuttle/escape)
"Rp" = (
/obj/structure/disposalpipe/junction/flip{
	dir = 8
	},
/turf/closed/wall/mineral/titanium,
/area/shuttle/escape)
"TX" = (
/obj/structure/chair/comfy/shuttle{
	dir = 1
	},
/obj/machinery/light/dim/directional/south,
/obj/structure/disposalpipe/segment{
	dir = 4
	},
/turf/open/floor/engine,
/area/shuttle/escape)
"Uy" = (
/obj/machinery/power/supermatter_crystal/shard/engine,
/turf/open/floor/engine,
/area/shuttle/escape)
"Vr" = (
/obj/structure/disposalpipe/segment{
	dir = 10
	},
/turf/closed/wall/mineral/titanium,
/area/shuttle/escape)
"Wu" = (
/turf/closed/wall/mineral/titanium,
/area/shuttle/escape)
"XH" = (
/obj/machinery/computer/communications{
	dir = 4
	},
/turf/open/floor/mineral/titanium/white,
/area/shuttle/escape)
"XJ" = (
/obj/structure/disposalpipe/segment{
	dir = 5
	},
/turf/closed/wall/mineral/titanium,
/area/shuttle/escape)
"XU" = (
/turf/template_noop,
/area/template_noop)
"YR" = (
/obj/machinery/light/dim/directional/north,
/obj/structure/chair/comfy/shuttle,
/turf/open/floor/engine,
/area/shuttle/escape)

(1,1,1) = {"
XU
XU
XU
Wu
Ei
Ei
Ei
Wu
XU
XU
XU
"}
(2,1,1) = {"
XU
XU
Wu
Wu
XH
zE
gU
Wu
Wu
XU
XU
"}
(3,1,1) = {"
XU
Wu
Wu
vf
HO
HO
HO
Wu
Wu
Wu
XU
"}
(4,1,1) = {"
Wu
yl
Bk
zI
yC
ED
op
Bk
Bk
XJ
Wu
"}
(5,1,1) = {"
Wu
DF
Wu
Wu
Wu
Wu
Wu
Wu
Wu
Qh
Wu
"}
(6,1,1) = {"
Wu
Vr
Bk
qw
FU
qd
kZ
gD
Wu
qF
Wu
"}
(7,1,1) = {"
Wu
Wu
Wu
YR
eg
vl
vl
DB
Ei
qF
Ei
"}
(8,1,1) = {"
xx
oJ
Bk
DC
eg
vl
vl
Mw
Wu
qF
Wu
"}
(9,1,1) = {"
Wu
Wu
Wu
Wu
wH
Wu
Wu
wH
Wu
xO
Wu
"}
(10,1,1) = {"
xx
oJ
wX
qw
Lh
HJ
vl
Mw
Wu
qF
Wu
"}
(11,1,1) = {"
Wu
yl
qD
aS
vl
eg
vl
TX
Ei
qF
Ei
"}
(12,1,1) = {"
Wu
Vr
qD
qw
FU
eg
vl
su
Wu
qF
Wu
"}
(13,1,1) = {"
Ei
Jt
ta
Bk
qD
BL
Wu
fy
Bk
lk
Wu
"}
(14,1,1) = {"
Wu
yl
qD
JR
nz
rf
vl
su
Wu
qF
Wu
"}
(15,1,1) = {"
Wu
Vr
qD
FR
eg
mb
vl
DB
Ei
qF
Ei
"}
(16,1,1) = {"
Ch
oJ
qD
PA
Lh
vl
vl
Mw
Wu
qF
Wu
"}
(17,1,1) = {"
Wu
Wu
wH
Rp
Bk
XJ
Wu
wH
Wu
xO
Wu
"}
(18,1,1) = {"
xx
oJ
qD
qh
xH
aI
xH
GQ
Wu
ya
xx
"}
(19,1,1) = {"
Fx
Wu
Vr
KY
xH
xH
xH
Mu
Ei
jl
pH
"}
(20,1,1) = {"
XU
Wu
Wu
GJ
xH
xH
xH
gc
vn
Uy
pH
"}
(21,1,1) = {"
XU
XU
Wu
Fx
Ei
Rh
KL
Fn
pH
pH
pH
"}
(22,1,1) = {"
XU
XU
XU
XU
XU
hl
XU
XU
XU
XU
XU
"}
