//MAP CONVERTED BY dmm2tgm.py THIS HEADER COMMENT PREVENTS RECONVERSION, DO NOT REMOVE
"d" = (
/obj/structure/shuttle/engine/propulsion,
/obj/effect/turf_decal/stripes/line,
/turf/open/floor/plating/airless,
/area/space)
"j" = (
/obj/structure/table/reinforced,
/obj/structure/reagent_dispensers/peppertank{
	pixel_x = -31
	},
/obj/item/restraints/handcuffs{
	pixel_y = 9
	},
/turf/open/floor/mineral/plastitanium/red,
/area/space)
"k" = (
/obj/machinery/door/airlock/shuttle{
	id_tag = "prisonshuttle";
	name = "Labor Shuttle Airlock"
	},
/obj/docking_port/mobile{
	dir = 8;
	dwidth = 2;
	height = 5;
	id = "laborcamp";
	name = "labor camp shuttle";
	port_direction = 4;
	width = 9
	},
/turf/open/floor/plating,
/area/space)
"m" = (
/obj/machinery/computer/shuttle/labor,
/turf/open/floor/mineral/plastitanium/red,
/area/space)
"n" = (
/obj/machinery/light,
/turf/open/floor/mineral/plastitanium/red,
/area/space)
"u" = (
/turf/open/floor/plasteel,
/area/space)
"w" = (
/obj/machinery/door/airlock/shuttle{
	name = "Labor Shuttle Airlock";
	req_access_txt = "2"
	},
/turf/open/floor/mineral/plastitanium/red,
/area/space)
"z" = (
/obj/machinery/mineral/stacking_machine/laborstacker{
	input_dir = 2;
	output_dir = 1
	},
/turf/open/floor/mineral/plastitanium/red,
/area/space)
"B" = (
/obj/structure/table/reinforced,
/turf/open/floor/mineral/plastitanium/red,
/area/space)
"D" = (
/obj/machinery/mineral/labor_claim_console{
	machinedir = 1;
	pixel_x = -30
	},
/obj/effect/turf_decal/bot,
/turf/open/floor/plasteel,
/area/space)
"F" = (
/obj/structure/window/reinforced{
	dir = 1;
	layer = 2.9
	},
/obj/structure/shuttle/engine/heater,
/obj/effect/turf_decal/stripes/line,
/turf/open/floor/plating/airless,
/area/space)
"H" = (
/turf/closed/wall/mineral/titanium,
/area/space)
"I" = (
/obj/effect/turf_decal/delivery,
/obj/structure/closet/crate/internals,
/turf/open/floor/plasteel,
/area/space)
"K" = (
/obj/machinery/door/airlock/shuttle{
	name = "Labor Shuttle Airlock";
	req_access_txt = "2"
	},
/turf/open/floor/plating,
/area/space)
"O" = (
/obj/machinery/button/flasher{
	id = "gulagshuttleflasher";
	name = "Flash Control";
	pixel_y = 28;
	req_access_txt = "1"
	},
/turf/open/floor/mineral/plastitanium/red,
/area/space)
"P" = (
/obj/structure/chair/comfy/shuttle{
	dir = 8
	},
/obj/effect/turf_decal/stripes/line{
	dir = 9
	},
/obj/machinery/flasher{
	id = "gulagshuttleflasher";
	pixel_x = 25
	},
/turf/open/floor/plasteel,
/area/space)
"Q" = (
/obj/effect/spawner/structure/window/shuttle,
/obj/structure/grille,
/obj/structure/cable,
/turf/open/floor/plating,
/area/space)
"R" = (
/obj/structure/chair/comfy/shuttle{
	dir = 8
	},
/obj/effect/turf_decal/stripes/line{
	dir = 10
	},
/turf/open/floor/plasteel,
/area/space)
"S" = (
/obj/effect/spawner/structure/window/shuttle,
/turf/open/floor/plating,
/area/space)
"W" = (
/obj/effect/turf_decal/delivery,
/turf/open/floor/plasteel,
/area/space)
"Y" = (
/obj/structure/chair/office{
	dir = 1
	},
/obj/machinery/mineral/stacking_unit_console{
	machinedir = 2;
	pixel_x = 30;
	pixel_y = 30
	},
/turf/open/floor/mineral/plastitanium/red,
/area/space)
"Z" = (
/turf/closed/wall/mineral/titanium/nodiagonal,
/area/space)

(1,1,1) = {"
H
H
Q
H
H
Q
H
H
H
"}
(2,1,1) = {"
S
j
O
z
D
W
I
H
d
"}
(3,1,1) = {"
S
m
Y
w
u
u
u
F
d
"}
(4,1,1) = {"
S
B
n
Z
P
R
u
H
d
"}
(5,1,1) = {"
H
H
K
H
H
H
k
H
H
"}
