//MAP CONVERTED BY dmm2tgm.py THIS HEADER COMMENT PREVENTS RECONVERSION, DO NOT REMOVE
"a" = (
/turf/closed/wall/mineral/titanium/nodiagonal,
/area/shuttle/labor)
"b" = (
/obj/structure/chair/comfy/shuttle{
	dir = 8
	},
/obj/effect/turf_decal/stripes/line{
	dir = 10
	},
/obj/machinery/light{
	dir = 4
	},
/turf/open/floor/plasteel,
/area/shuttle/labor)
"d" = (
/obj/structure/shuttle/engine/propulsion,
/obj/effect/turf_decal/stripes/line,
/turf/open/floor/plating/airless,
/area/shuttle/labor)
"j" = (
/obj/structure/table/reinforced,
/obj/structure/reagent_dispensers/peppertank{
	pixel_x = -31
	},
/obj/item/restraints/handcuffs{
	pixel_y = 9
	},
/turf/open/floor/mineral/plastitanium/red,
/area/shuttle/labor)
"k" = (
/obj/machinery/door/airlock/shuttle{
	id_tag = "prisonshuttle";
	name = "Labor Shuttle Airlock"
	},
/obj/docking_port/mobile{
	dir = 8;
	dwidth = 2;
	height = 5;
	id = "laborcamp";
	name = "labor camp shuttle";
	port_direction = 4;
	width = 9
	},
/turf/open/floor/plating,
/area/shuttle/labor)
"m" = (
/obj/machinery/computer/shuttle/labor,
/turf/open/floor/mineral/plastitanium/red,
/area/shuttle/labor)
"n" = (
/obj/machinery/light,
/turf/open/floor/mineral/plastitanium/red,
/area/shuttle/labor)
"u" = (
/turf/open/floor/plasteel,
/area/shuttle/labor)
"w" = (
/obj/machinery/door/airlock/shuttle{
	name = "Labor Shuttle Airlock";
	req_access_txt = "2"
	},
/turf/open/floor/mineral/plastitanium/red,
/area/shuttle/labor)
"z" = (
/obj/machinery/mineral/stacking_machine/laborstacker{
	input_dir = 2;
	output_dir = 1
	},
/turf/open/floor/mineral/plastitanium/red,
/area/shuttle/labor)
"B" = (
/obj/structure/table/reinforced,
/turf/open/floor/mineral/plastitanium/red,
/area/shuttle/labor)
"D" = (
/obj/machinery/mineral/labor_claim_console{
	machinedir = 1;
	pixel_x = -30
	},
/obj/effect/turf_decal/bot,
/turf/open/floor/plasteel,
/area/shuttle/labor)
"F" = (
/obj/structure/window/reinforced{
	dir = 1;
	layer = 2.9
	},
/obj/structure/shuttle/engine/heater,
/obj/effect/turf_decal/stripes/line,
/turf/open/floor/plating/airless,
/area/shuttle/labor)
"H" = (
/turf/closed/wall/mineral/titanium,
/area/shuttle/labor)
"I" = (
/obj/effect/turf_decal/delivery,
/obj/structure/closet/crate/internals,
/turf/open/floor/plasteel,
/area/shuttle/labor)
"K" = (
/obj/machinery/door/airlock/shuttle{
	name = "Labor Shuttle Airlock";
	req_access_txt = "2"
	},
/turf/open/floor/plating,
/area/shuttle/labor)
"O" = (
/obj/machinery/button/flasher{
	id = "gulagshuttleflasher";
	name = "Flash Control";
	pixel_y = 28;
	req_access_txt = "1"
	},
/turf/open/floor/mineral/plastitanium/red,
/area/shuttle/labor)
"P" = (
/obj/structure/chair/comfy/shuttle{
	dir = 8
	},
/obj/effect/turf_decal/stripes/line{
	dir = 9
	},
/obj/machinery/flasher{
	id = "gulagshuttleflasher";
	pixel_x = 25
	},
/turf/open/floor/plasteel,
/area/shuttle/labor)
"Q" = (
/obj/effect/spawner/structure/window/shuttle,
/obj/structure/grille,
/obj/structure/cable,
/turf/open/floor/plating,
/area/shuttle/labor)
"S" = (
/obj/effect/spawner/structure/window/shuttle,
/turf/open/floor/plating,
/area/shuttle/labor)
"W" = (
/obj/effect/turf_decal/delivery,
/turf/open/floor/plasteel,
/area/shuttle/labor)
"Y" = (
/obj/structure/chair/office{
	dir = 1
	},
/obj/machinery/mineral/stacking_unit_console{
	machinedir = 2;
	pixel_x = 30;
	pixel_y = 30
	},
/turf/open/floor/mineral/plastitanium/red,
/area/shuttle/labor)

(1,1,1) = {"
H
H
Q
H
H
Q
H
H
H
"}
(2,1,1) = {"
S
j
O
z
D
W
I
H
d
"}
(3,1,1) = {"
S
m
Y
w
u
u
u
F
d
"}
(4,1,1) = {"
S
B
n
H
P
b
u
H
d
"}
(5,1,1) = {"
H
H
K
a
H
H
k
H
H
"}
