//MAP CONVERTED BY dmm2tgm.py THIS HEADER COMMENT PREVENTS RECONVERSION, DO NOT REMOVE
"a" = (
/obj/effect/turf_decal/tile/brown{
	dir = 1
	},
/obj/effect/turf_decal/tile/brown,
/obj/effect/turf_decal/tile/brown{
	dir = 8
	},
/obj/effect/turf_decal/tile/brown{
	dir = 4
	},
/obj/structure/ore_box,
/turf/open/floor/mineral/titanium/yellow,
/area/shuttle/mining)
"b" = (
/obj/structure/window/reinforced{
	dir = 1
	},
/obj/structure/window/reinforced{
	dir = 4
	},
/obj/structure/shuttle/engine/heater{
	pixel_x = -3;
	pixel_y = 2
	},
/turf/open/floor/plating/airless,
/area/shuttle/mining)
"c" = (
/obj/effect/turf_decal/tile/brown{
	dir = 1
	},
/obj/effect/turf_decal/tile/brown,
/obj/effect/decal/cleanable/blood/bubblegum,
/turf/open/floor/mineral/titanium/white,
/area/shuttle/mining)
"d" = (
/obj/structure/shuttle/engine/propulsion/burst{
	dir = 4
	},
/turf/open/floor/plating/airless,
/area/shuttle/mining)
"e" = (
/obj/effect/turf_decal/tile/brown{
	dir = 1
	},
/obj/effect/turf_decal/tile/brown,
/obj/effect/turf_decal/stripes/corner{
	dir = 4
	},
/turf/open/floor/mineral/titanium/white,
/area/shuttle/mining)
"f" = (
/obj/effect/turf_decal/tile/brown{
	dir = 1
	},
/obj/effect/turf_decal/tile/brown,
/turf/open/floor/mineral/titanium,
/area/shuttle/mining)
"g" = (
/obj/effect/turf_decal/tile/brown{
	dir = 1
	},
/obj/effect/turf_decal/tile/brown,
/obj/structure/chair/comfy/shuttle{
	dir = 4
	},
/obj/effect/decal/cleanable/blood/bubblegum,
/turf/open/floor/mineral/titanium,
/area/shuttle/mining)
"h" = (
/obj/effect/turf_decal/tile/brown{
	dir = 1
	},
/obj/effect/turf_decal/tile/brown,
/obj/machinery/light,
/turf/open/floor/mineral/titanium/white,
/area/shuttle/mining)
"i" = (
/turf/closed/wall/mineral/titanium,
/area/shuttle/mining)
"j" = (
/obj/effect/turf_decal/tile/brown{
	dir = 1
	},
/obj/effect/turf_decal/tile/brown,
/obj/effect/turf_decal/tile/brown{
	dir = 8
	},
/obj/effect/turf_decal/tile/brown{
	dir = 4
	},
/obj/machinery/computer/shuttle/mining{
	dir = 8
	},
/turf/open/floor/mineral/titanium/yellow,
/area/shuttle/mining)
"m" = (
/obj/effect/turf_decal/tile/brown{
	dir = 1
	},
/obj/effect/turf_decal/tile/brown,
/obj/effect/turf_decal/stripes/line{
	dir = 1
	},
/obj/effect/decal/cleanable/blood/tracks{
	dir = 10
	},
/obj/effect/decal/cleanable/blood/footprints{
	dir = 8
	},
/turf/open/floor/mineral/titanium/white,
/area/shuttle/mining)
"n" = (
/obj/effect/turf_decal/tile/brown{
	dir = 1
	},
/obj/effect/turf_decal/tile/brown,
/obj/structure/chair/comfy/shuttle{
	dir = 4
	},
/turf/open/floor/mineral/titanium,
/area/shuttle/mining)
"x" = (
/obj/effect/turf_decal/tile/brown{
	dir = 1
	},
/obj/effect/turf_decal/tile/brown,
/obj/effect/turf_decal/tile/brown{
	dir = 8
	},
/obj/effect/turf_decal/tile/brown{
	dir = 4
	},
/obj/structure/table,
/obj/item/stack/sheet/bone,
/turf/open/floor/mineral/titanium/yellow,
/area/shuttle/mining)
"z" = (
/obj/effect/turf_decal/tile/brown{
	dir = 1
	},
/obj/effect/turf_decal/tile/brown,
/obj/effect/turf_decal/tile/brown{
	dir = 8
	},
/obj/effect/turf_decal/tile/brown{
	dir = 4
	},
/obj/structure/table,
/obj/item/organ/tongue/bone,
/turf/open/floor/mineral/titanium/yellow,
/area/shuttle/mining)
"D" = (
/obj/effect/turf_decal/tile/brown{
	dir = 1
	},
/obj/effect/turf_decal/tile/brown,
/obj/effect/turf_decal/tile/brown{
	dir = 8
	},
/obj/effect/turf_decal/tile/brown{
	dir = 4
	},
/obj/item/stack/sheet/bone,
/turf/open/floor/mineral/titanium/yellow,
/area/shuttle/mining)
"E" = (
/obj/effect/turf_decal/tile/brown{
	dir = 1
	},
/obj/effect/turf_decal/tile/brown,
/obj/effect/decal/cleanable/blood/tracks{
	dir = 6
	},
/obj/effect/decal/cleanable/blood/innards,
/turf/open/floor/mineral/titanium,
/area/shuttle/mining)
"G" = (
/obj/effect/turf_decal/tile/brown{
	dir = 1
	},
/obj/effect/turf_decal/tile/brown,
/obj/effect/decal/cleanable/blood/tracks,
/obj/effect/decal/cleanable/blood/footprints{
	dir = 1
	},
/turf/open/floor/mineral/titanium,
/area/shuttle/mining)
"H" = (
/obj/effect/decal/cleanable/blood/tracks,
/obj/effect/decal/cleanable/blood/footprints{
	dir = 1
	},
/obj/machinery/door/airlock/titanium{
	name = "Mining Shuttle Airlock"
	},
/obj/docking_port/mobile{
	dir = 2;
	dwidth = 4;
	height = 6;
	id = "mining";
	name = "mining shuttle";
	port_direction = 8;
	width = 8
	},
/turf/open/floor/mineral/titanium,
/area/shuttle/mining)
"I" = (
/obj/effect/turf_decal/tile/brown{
	dir = 1
	},
/obj/effect/turf_decal/tile/brown,
/turf/open/floor/mineral/titanium/white,
/area/shuttle/mining)
"J" = (
/obj/structure/window/reinforced{
	dir = 4
	},
/obj/structure/window/reinforced,
/obj/structure/shuttle/engine/heater{
	pixel_x = -3;
	pixel_y = 4
	},
/turf/open/floor/plating/airless,
/area/shuttle/mining)
"K" = (
/obj/effect/spawner/structure/window/shuttle,
/turf/open/floor/plating/airless,
/area/shuttle/mining)
"M" = (
/obj/effect/turf_decal/tile/brown{
	dir = 1
	},
/obj/effect/turf_decal/tile/brown,
/obj/item/stack/ore/plasma,
/turf/open/floor/mineral/titanium/white,
/area/shuttle/mining)
"Q" = (
/obj/effect/turf_decal/tile/brown{
	dir = 1
	},
/obj/effect/turf_decal/tile/brown,
/obj/effect/turf_decal/stripes/corner{
	dir = 1
	},
/obj/effect/decal/cleanable/blood/tracks{
	dir = 5
	},
/obj/effect/decal/cleanable/blood/footprints{
	dir = 1
	},
/turf/open/floor/mineral/titanium/white,
/area/shuttle/mining)
"V" = (
/obj/effect/turf_decal/tile/brown{
	dir = 1
	},
/obj/effect/turf_decal/tile/brown,
/obj/effect/turf_decal/tile/brown{
	dir = 8
	},
/obj/effect/turf_decal/tile/brown{
	dir = 4
	},
/turf/open/floor/mineral/titanium/yellow,
/area/shuttle/mining)

(1,1,1) = {"
i
d
i
i
d
i
"}
(2,1,1) = {"
i
J
a
D
b
i
"}
(3,1,1) = {"
i
e
f
f
M
i
"}
(4,1,1) = {"
H
m
n
g
I
i
"}
(5,1,1) = {"
i
Q
G
E
h
i
"}
(6,1,1) = {"
K
I
n
f
c
K
"}
(7,1,1) = {"
i
x
j
V
z
i
"}
(8,1,1) = {"
i
i
K
K
i
i
"}
