//MAP CONVERTED BY dmm2tgm.py THIS HEADER COMMENT PREVENTS RECONVERSION, DO NOT REMOVE
"a" = (
/obj/effect/turf_decal/tile/brown{
	dir = 1
	},
/obj/effect/turf_decal/tile/brown,
/obj/effect/turf_decal/tile/brown{
	dir = 8
	},
/obj/effect/turf_decal/tile/brown{
	dir = 4
	},
/obj/effect/turf_decal/tile/brown{
	dir = 1
	},
/obj/effect/turf_decal/tile/brown,
/obj/effect/decal/cleanable/blood/tracks{
	dir = 4
	},
/turf/open/floor/mineral/titanium/yellow,
/area/shuttle/mining)
"b" = (
/obj/structure/table,
/obj/effect/turf_decal/tile/brown{
	dir = 1
	},
/obj/effect/turf_decal/tile/brown,
/turf/open/floor/mineral/titanium/white,
/area/shuttle/mining)
"e" = (
/obj/structure/chair/comfy/shuttle{
	dir = 1
	},
/obj/effect/turf_decal/tile/brown{
	dir = 1
	},
/obj/effect/turf_decal/tile/brown,
/turf/open/floor/mineral/titanium/white,
/area/shuttle/mining)
"f" = (
/obj/effect/turf_decal/tile/brown{
	dir = 1
	},
/obj/effect/turf_decal/tile/brown,
/turf/open/floor/mineral/titanium/white,
/area/shuttle/mining)
"h" = (
/obj/effect/turf_decal/tile/brown{
	dir = 1
	},
/obj/effect/turf_decal/tile/brown,
/obj/item/stack/ore/plasma,
/turf/open/floor/mineral/titanium/white,
/area/shuttle/mining)
"i" = (
/turf/closed/wall/mineral/titanium,
/area/shuttle/mining)
"j" = (
/obj/machinery/computer/shuttle/mining,
/obj/effect/turf_decal/tile/brown{
	dir = 1
	},
/obj/effect/turf_decal/tile/brown,
/turf/open/floor/mineral/titanium/white,
/area/shuttle/mining)
"m" = (
/obj/effect/turf_decal/tile/brown{
	dir = 1
	},
/obj/effect/turf_decal/tile/brown,
/obj/effect/turf_decal/tile/brown{
	dir = 8
	},
/obj/effect/turf_decal/tile/brown{
	dir = 4
	},
/obj/effect/turf_decal/tile/brown{
	dir = 1
	},
/obj/effect/turf_decal/tile/brown,
/obj/effect/decal/cleanable/blood/tracks,
/obj/effect/decal/cleanable/blood/innards,
/turf/open/floor/mineral/titanium/yellow,
/area/shuttle/mining)
"n" = (
/obj/machinery/light{
	dir = 4
	},
/obj/effect/turf_decal/tile/brown{
	dir = 1
	},
/obj/effect/turf_decal/tile/brown,
/obj/effect/turf_decal/tile/brown{
	dir = 8
	},
/obj/effect/turf_decal/tile/brown{
	dir = 4
	},
/obj/effect/turf_decal/tile/brown{
	dir = 1
	},
/obj/effect/turf_decal/tile/brown,
/obj/effect/decal/cleanable/blood/tracks{
	dir = 6
	},
/turf/open/floor/mineral/titanium/yellow,
/area/shuttle/mining)
"x" = (
/obj/structure/shuttle/engine/propulsion/burst,
/turf/open/floor/plating/airless,
/area/shuttle/mining)
"z" = (
/obj/machinery/door/airlock/titanium{
	name = "Mining Shuttle Airlock"
	},
/obj/docking_port/mobile{
	dir = 4;
	dwidth = 3;
	height = 5;
	id = "mining";
	name = "mining shuttle";
	port_direction = 8;
	width = 7
	},
/turf/open/floor/plating,
/area/shuttle/mining)
"D" = (
/obj/effect/turf_decal/tile/brown{
	dir = 1
	},
/obj/effect/turf_decal/tile/brown,
/obj/effect/turf_decal/tile/brown{
	dir = 8
	},
/obj/effect/turf_decal/tile/brown{
	dir = 4
	},
/obj/effect/turf_decal/tile/brown{
	dir = 1
	},
/obj/effect/turf_decal/tile/brown,
/turf/open/floor/mineral/titanium/yellow,
/area/shuttle/mining)
"G" = (
/obj/structure/chair/comfy/shuttle,
/obj/effect/turf_decal/tile/brown{
	dir = 1
	},
/obj/effect/turf_decal/tile/brown,
/turf/open/floor/mineral/titanium/white,
/area/shuttle/mining)
"H" = (
/obj/structure/chair/comfy/shuttle,
/obj/effect/turf_decal/tile/brown{
	dir = 1
	},
/obj/effect/turf_decal/tile/brown,
/obj/effect/decal/cleanable/blood/splatter,
/turf/open/floor/mineral/titanium/white,
/area/shuttle/mining)
"I" = (
/obj/effect/spawner/structure/window/shuttle,
/turf/open/floor/plating,
/area/shuttle/mining)
"J" = (
/obj/effect/turf_decal/tile/brown{
	dir = 1
	},
/obj/effect/turf_decal/tile/brown,
/obj/effect/turf_decal/tile/brown{
	dir = 8
	},
/obj/effect/turf_decal/tile/brown{
	dir = 4
	},
/obj/effect/turf_decal/tile/brown{
	dir = 1
	},
/obj/effect/turf_decal/tile/brown,
/obj/item/stack/sheet/bone,
/turf/open/floor/mineral/titanium/yellow,
/area/shuttle/mining)
"M" = (
/obj/structure/shuttle/engine/heater,
/obj/structure/window/reinforced{
	dir = 1;
	layer = 2.9
	},
/obj/structure/window/reinforced{
	dir = 4;
	layer = 2.9
	},
/obj/structure/window/reinforced{
	dir = 8;
	layer = 2.9
	},
/turf/open/floor/plating,
/area/shuttle/mining)
"Q" = (
/obj/effect/turf_decal/tile/brown{
	dir = 1
	},
/obj/effect/turf_decal/tile/brown,
/obj/effect/turf_decal/tile/brown{
	dir = 8
	},
/obj/effect/turf_decal/tile/brown{
	dir = 4
	},
/obj/effect/turf_decal/tile/brown{
	dir = 1
	},
/obj/effect/turf_decal/tile/brown,
/obj/effect/decal/cleanable/blood/tracks{
	dir = 4
	},
/obj/effect/decal/cleanable/blood/splatter,
/turf/open/floor/mineral/titanium/yellow,
/area/shuttle/mining)

(1,1,1) = {"
i
i
I
z
I
i
i
"}
(2,1,1) = {"
I
G
J
a
D
b
i
"}
(3,1,1) = {"
I
j
e
Q
f
M
x
"}
(4,1,1) = {"
I
H
m
n
D
h
i
"}
(5,1,1) = {"
i
i
I
i
I
i
i
"}
