//MAP CONVERTED BY dmm2tgm.py THIS HEADER COMMENT PREVENTS RECONVERSION, DO NOT REMOVE
"a" = (
/obj/effect/turf_decal/stripes/line{
	dir = 8
	},
/obj/effect/turf_decal/tile/brown,
/obj/effect/turf_decal/tile/brown{
	dir = 1
	},
/obj/effect/decal/cleanable/blood/tracks{
	dir = 6
	},
/obj/effect/decal/cleanable/blood/footprints,
/turf/open/floor/mineral/titanium/white,
/area/shuttle/mining)
"b" = (
/obj/structure/window/reinforced{
	dir = 1
	},
/obj/structure/window/reinforced{
	dir = 4
	},
/obj/structure/shuttle/engine/heater{
	pixel_x = -3;
	pixel_y = 2
	},
/turf/open/floor/plating/airless,
/area/shuttle/mining)
"c" = (
/obj/effect/turf_decal/tile/brown,
/obj/effect/turf_decal/tile/brown{
	dir = 1
	},
/obj/structure/table,
/turf/open/floor/mineral/titanium/white,
/area/shuttle/mining)
"d" = (
/obj/effect/turf_decal/tile/brown,
/obj/effect/turf_decal/tile/brown{
	dir = 1
	},
/obj/machinery/computer/shuttle/mining,
/turf/open/floor/mineral/titanium/white,
/area/shuttle/mining)
"e" = (
/obj/effect/turf_decal/tile/brown{
	dir = 1
	},
/obj/effect/turf_decal/tile/brown,
/obj/effect/decal/cleanable/blood/tracks{
	dir = 4
	},
/obj/effect/decal/cleanable/blood/footprints{
	dir = 8
	},
/turf/open/floor/mineral/titanium,
/area/shuttle/mining)
"f" = (
/obj/effect/turf_decal/tile/brown{
	dir = 1
	},
/obj/effect/turf_decal/tile/brown,
/turf/open/floor/mineral/titanium,
/area/shuttle/mining)
"g" = (
/obj/effect/turf_decal/tile/brown,
/obj/effect/turf_decal/tile/brown{
	dir = 1
	},
/obj/structure/ore_box,
/turf/open/floor/mineral/titanium/white,
/area/shuttle/mining)
"h" = (
/obj/structure/shuttle/engine/heater{
	pixel_x = -3;
	pixel_y = 2
	},
/obj/structure/window/reinforced{
	dir = 1;
	layer = 2.9
	},
/obj/structure/window/reinforced{
	dir = 8
	},
/turf/open/floor/plating/airless,
/area/shuttle/mining)
"i" = (
/turf/closed/wall/mineral/titanium,
/area/shuttle/mining)
"j" = (
/obj/effect/turf_decal/tile/brown,
/obj/effect/turf_decal/tile/brown{
	dir = 1
	},
/obj/effect/decal/cleanable/blood/footprints,
/obj/structure/chair/comfy/shuttle{
	dir = 1
	},
/turf/open/floor/mineral/titanium,
/area/shuttle/mining)
"m" = (
/obj/effect/turf_decal/tile/brown{
	dir = 1
	},
/obj/effect/turf_decal/tile/brown,
/obj/effect/decal/cleanable/blood/footprints{
	dir = 8
	},
/obj/effect/decal/cleanable/blood/innards,
/obj/effect/decal/cleanable/blood/tracks{
	dir = 5
	},
/turf/open/floor/mineral/titanium,
/area/shuttle/mining)
"n" = (
/obj/effect/turf_decal/tile/brown{
	dir = 1
	},
/obj/effect/turf_decal/tile/brown,
/obj/structure/chair/comfy/shuttle{
	dir = 1
	},
/obj/effect/decal/cleanable/blood/bubblegum,
/turf/open/floor/mineral/titanium,
/area/shuttle/mining)
"x" = (
/obj/effect/turf_decal/tile/brown,
/obj/effect/turf_decal/tile/brown{
	dir = 1
	},
/obj/item/stack/sheet/bone,
/obj/machinery/light{
	dir = 4
	},
/turf/open/floor/mineral/titanium/white,
/area/shuttle/mining)
"z" = (
/obj/effect/decal/cleanable/blood/tracks{
	dir = 4
	},
/turf/closed/wall/mineral/titanium,
/area/shuttle/mining)
"D" = (
/obj/effect/turf_decal/stripes/corner{
	dir = 1
	},
/obj/effect/turf_decal/tile/brown,
/obj/effect/turf_decal/tile/brown{
	dir = 1
	},
/turf/open/floor/mineral/titanium/white,
/area/shuttle/mining)
"E" = (
/obj/effect/turf_decal/tile/brown{
	dir = 1
	},
/obj/effect/turf_decal/tile/brown,
/obj/machinery/light{
	dir = 4
	},
/turf/open/floor/mineral/titanium/white,
/area/shuttle/mining)
"G" = (
/obj/effect/turf_decal/tile/brown,
/obj/effect/turf_decal/tile/brown{
	dir = 1
	},
/turf/open/floor/mineral/titanium/white,
/area/shuttle/mining)
"H" = (
/obj/effect/turf_decal/tile/brown,
/obj/effect/turf_decal/tile/brown{
	dir = 1
	},
/turf/open/floor/mineral/titanium,
/area/shuttle/mining)
"I" = (
/obj/effect/turf_decal/tile/brown{
	dir = 1
	},
/obj/effect/turf_decal/tile/brown,
/turf/open/floor/mineral/titanium/white,
/area/shuttle/mining)
"J" = (
/obj/effect/turf_decal/stripes/corner{
	dir = 8
	},
/obj/effect/turf_decal/tile/brown,
/obj/effect/turf_decal/tile/brown{
	dir = 1
	},
/obj/effect/decal/cleanable/blood/tracks{
	dir = 9
	},
/turf/open/floor/mineral/titanium/white,
/area/shuttle/mining)
"K" = (
/obj/effect/spawner/structure/window/shuttle,
/turf/open/floor/plating/airless,
/area/shuttle/mining)
"M" = (
/obj/effect/turf_decal/tile/brown{
	dir = 1
	},
/obj/effect/turf_decal/tile/brown,
/obj/item/stack/ore/plasma,
/obj/structure/table,
/turf/open/floor/mineral/titanium/white,
/area/shuttle/mining)
"Q" = (
/obj/effect/turf_decal/tile/brown{
	dir = 1
	},
/obj/effect/turf_decal/tile/brown,
/obj/structure/chair/comfy/shuttle{
	dir = 1
	},
/turf/open/floor/mineral/titanium,
/area/shuttle/mining)
"S" = (
/obj/structure/shuttle/engine/propulsion/burst,
/turf/open/floor/plating/airless,
/area/shuttle/mining)
"V" = (
/obj/machinery/door/airlock/titanium{
	name = "Mining Shuttle Airlock"
	},
/obj/docking_port/mobile{
	dir = 8;
	dwidth = 4;
	height = 5;
	id = "mining";
	name = "mining shuttle";
	port_direction = 4;
	width = 6
	},
/turf/open/floor/mineral/titanium/white,
/area/shuttle/mining)

(1,1,1) = {"
i
i
K
i
z
i
i
i
"}
(2,1,1) = {"
i
c
G
J
a
D
b
S
"}
(3,1,1) = {"
K
d
j
e
Q
f
M
i
"}
(4,1,1) = {"
K
g
H
m
n
f
I
i
"}
(5,1,1) = {"
i
c
x
I
G
E
h
S
"}
(6,1,1) = {"
i
i
K
i
V
i
i
i
"}
