//MAP CONVERTED BY dmm2tgm.py THIS HEADER COMMENT PREVENTS RECONVERSION, DO NOT REMOVE
"d" = (
/obj/structure/shuttle/engine/heater,
/obj/structure/window/reinforced{
	dir = 1;
	layer = 2.9
	},
/obj/structure/window/reinforced{
	dir = 4;
	layer = 2.9
	},
/obj/structure/window/reinforced{
	dir = 8;
	layer = 2.9
	},
/turf/open/floor/plating,
/area/space)
"h" = (
/obj/effect/spawner/structure/window/shuttle,
/turf/open/floor/plating,
/area/space)
"i" = (
/turf/closed/wall/mineral/titanium,
/area/space)
"y" = (
/obj/structure/table,
/turf/open/floor/mineral/titanium/white,
/area/space)
"B" = (
/obj/structure/shuttle/engine/propulsion/burst,
/turf/open/floor/plating/airless,
/area/space)
"F" = (
/turf/template_noop,
/area/space)
"G" = (
/turf/open/floor/mineral/titanium/white,
/area/space)
"I" = (
/obj/structure/chair/comfy/shuttle,
/turf/open/floor/mineral/titanium/white,
/area/space)
"N" = (
/obj/effect/turf_decal/tile/brown{
	dir = 1
	},
/obj/effect/turf_decal/tile/brown,
/obj/effect/turf_decal/tile/brown{
	dir = 8
	},
/obj/effect/turf_decal/tile/brown{
	dir = 4
	},
/turf/open/floor/mineral/titanium/yellow,
/area/space)
"O" = (
/obj/machinery/door/airlock/titanium{
	name = "Mining Shuttle Airlock"
	},
/obj/docking_port/mobile{
	dir = 4;
	dwidth = 3;
	height = 5;
	id = "mining";
	name = "mining shuttle";
	port_direction = 8;
	width = 7
	},
/turf/open/floor/plating,
/area/space)
"R" = (
/obj/structure/chair/comfy/shuttle{
	dir = 1
	},
/turf/open/floor/mineral/titanium/white,
/area/space)
"T" = (
/obj/machinery/light{
	dir = 4
	},
/obj/effect/turf_decal/tile/brown{
	dir = 1
	},
/obj/effect/turf_decal/tile/brown,
/obj/effect/turf_decal/tile/brown{
	dir = 8
	},
/obj/effect/turf_decal/tile/brown{
	dir = 4
	},
/turf/open/floor/mineral/titanium/yellow,
/area/space)
"W" = (
/obj/machinery/computer/shuttle/mining,
/turf/open/floor/mineral/titanium/white,
/area/space)

(1,1,1) = {"
F
i
h
O
h
i
i
"}
(2,1,1) = {"
h
I
N
N
N
y
i
"}
(3,1,1) = {"
h
W
R
N
G
d
B
"}
(4,1,1) = {"
h
I
N
T
N
G
i
"}
(5,1,1) = {"
F
i
h
i
h
i
i
"}
